1739835299792
4
0,400,-206,0,0,23,4,270
0,412,-206,138,0,23,2,137
0,417,-206,138,0,19,2,43
0,425,-206,91,0,19,4,60
1739835300298
8
0,429,-206,19,0,19,4,90
0,430,-206,0,0,19,4,30
0,430,-206,0,0,19,4,30
0,429,30,0,180,0,6,90
0,429,34,0,0,0,6,20
0,429,34,0,0,62,4,250
