1739835352321
2
0,118,-208,0,0,27,4,210
0,118,-238,0,0,-1,14,300
1739835352829
1
0,118,-289,0,0,-1,14,510
1739835353338
1
0,118,-340,0,0,-1,14,510
1739835353848
1
0,118,-391,0,0,-1,14,510
1739835354358
5
0,118,-419,0,0,-1,14,210
0,118,-419,0,0,0,6,30
0,118,-418,0,60,0,6,30
0,118,-416,0,0,0,6,20
0,118,-416,0,0,6,4,220
