1739835420148
7
0,716,-416,0,0,14,4,30
0,725,-416,138,0,14,2,120
0,727,-416,130,0,14,4,10
0,729,-416,130,0,12,4,20
0,733,-416,106,0,12,10,30
0,735,-414,0,0,12,10,0
0,735,-384,0,0,-2,14,300
1739835420662
1
0,735,-333,0,0,-2,14,510
1739835421174
1
0,735,-282,0,0,-2,14,510
1739835421678
1
0,735,-231,0,0,-2,14,510
1739835422187
1
0,735,-180,0,0,-2,14,510
1739835422698
3
0,735,-147,0,0,-2,14,300
0,735,-146,0,0,0,6,60
0,735,-146,0,0,32,4,150
