1739835438510
2
0,735,-416,0,0,12,4,300
0,757,-416,139,0,12,2,210
1739835439020
4
0,803,-416,138,0,12,2,331
0,807,-416,138,0,0,6,29
0,819,-407,138,180,0,6,90
0,827,-393,127,300,0,7,60
1739835439528
4
0,864,-166,75,670,0,7,390
0,867,-146,36,0,0,7,30
0,867,-146,12,0,28,5,30
0,868,-146,0,0,28,5,60
1739835440041
4
0,868,-146,0,0,28,5,150
0,862,-146,-127,0,28,3,92
0,833,-146,-138,0,31,3,208
0,827,-146,-91,0,31,5,60
1739835440548
2
0,822,-146,-19,0,31,5,90
0,822,-146,0,0,31,5,420
