1739751268634
2
0,933,2,0,0,62,5,60
0,933,-43,0,0,-2,15,450
1739751269130
1
0,933,-94,0,0,-2,15,510
1739751269646
1
0,933,-145,0,0,-2,15,510
1739751270152
1
0,933,-196,0,0,-2,15,510
1739751270659
1
0,933,-247,0,0,-2,15,510
1739751271181
5
0,933,-269,0,0,-2,15,150
0,933,-269,0,0,0,7,30
0,933,-268,0,60,0,7,30
0,933,-266,0,0,0,7,20
0,933,-266,0,0,46,5,280
