1739751255868
7
0,423,4,0,0,54,5,90
0,423,4,0,0,54,5,30
0,457,-269,0,180,0,7,90
0,457,-266,0,0,0,7,20
0,457,-266,0,0,50,5,280
