1739751568510
2
0,430,4,0,0,54,5,360
0,416,4,-139,0,54,3,150
1739751569009
4
0,405,4,-138,0,54,3,79
0,367,4,-138,0,69,3,273
0,365,4,-138,0,0,7,8
0,345,27,-139,300,0,7,150
1739751569519
2
0,342,34,-69,0,0,7,21
0,277,34,-139,0,78,3,489
1739751570039
3
0,270,34,-89,0,78,5,61
0,262,34,-17,0,79,5,119
0,262,34,0,0,79,5,330
