1739751286469
3
0,933,-266,0,0,46,5,120
0,933,-264,0,0,46,11,30
0,933,-228,0,0,-2,15,360
1739751286996
1
0,933,-177,0,0,-2,15,510
1739751287502
1
0,933,-126,0,0,-2,15,510
1739751288002
1
0,933,-75,0,0,-2,15,510
1739751288512
1
0,933,-24,0,0,-2,15,510
1739751289027
3
0,933,3,0,0,-2,15,240
0,933,4,0,0,0,7,60
0,933,4,0,0,62,11,210
1739751289532
2
0,933,4,0,0,62,11,180
0,933,4,0,0,62,5,330
