1739751315545
5
0,454,-266,0,0,50,5,450
0,454,-266,0,0,50,5,30
0,503,-548,0,60,0,7,30
1739751316048
3
0,503,-540,0,180,0,7,60
0,503,-536,0,0,0,7,21
0,503,-536,0,0,16,5,429
