1739751336449
2
0,1033,-538,0,0,24,5,210
0,1033,-568,0,0,-1,15,300
1739751336959
1
0,1033,-619,0,0,-1,15,510
1739751337473
1
0,1033,-670,0,0,-1,15,510
1739751337993
1
0,1033,-721,0,0,-1,15,510
1739751338492
1
0,1033,-772,0,0,-1,15,510
1739751339004
5
0,1033,-809,0,0,-1,15,300
0,1033,-809,0,0,0,7,30
0,1033,-808,0,60,0,7,30
0,1033,-806,0,0,0,7,20
0,1033,-806,0,0,5,5,130
