1739751350223
3
0,1033,-806,0,0,5,5,120
0,1033,-804,0,0,5,11,30
0,1033,-768,0,0,-1,15,360
1739751350728
1
0,1033,-717,0,0,-1,15,510
1739751351249
1
0,1033,-666,0,0,-1,15,510
1739751351749
1
0,1033,-615,0,0,-1,15,510
1739751352260
1
0,1033,-564,0,0,-1,15,510
1739751352779
3
0,1033,-537,0,0,-1,15,240
0,1033,-536,0,0,0,7,60
0,1033,-536,0,0,23,11,210
1739751353280
2
0,1033,-536,0,0,23,11,150
0,1033,-536,0,0,23,5,360
