1739751236491
2
0,279,34,0,0,78,4,210
0,314,34,139,0,78,2,300
1739751237002
4
0,338,33,138,0,78,2,180
0,376,-43,138,-15,0,6,270
0,385,-41,139,105,0,6,60
1739751237513
4
0,405,-2,139,405,0,6,150
0,408,4,69,0,0,6,16
0,443,4,138,0,54,2,272
0,453,4,139,0,70,2,72
1739751238029
3
0,477,4,138,0,70,2,180
0,489,4,18,0,70,4,150
0,490,4,0,0,70,4,180
