1739751050851
2
0,1499,4,0,0,55,5,360
0,1485,4,-139,0,55,3,150
1739751051367
2
0,1447,4,-138,0,55,3,273
0,1414,4,-139,0,67,3,237
1739751051869
2
0,1395,4,-138,0,67,3,136
0,1343,4,-139,0,66,3,374
1739751052380
2
0,1305,4,-138,0,66,3,273
0,1272,4,-139,0,64,3,237
1739751052903
2
0,1215,4,-138,0,64,3,410
0,1201,4,-139,0,65,3,100
1739751053398
1
0,1130,4,-139,0,65,3,510
1739751053909
2
0,1125,4,-138,0,65,3,36
0,1059,4,-139,0,61,3,474
1739751054430
2
0,1035,4,-138,0,61,3,172
0,988,4,-139,0,63,3,338
1739751054932
2
0,945,4,-138,0,63,3,309
0,917,4,-139,0,62,3,201
1739751055439
2
0,855,4,-138,0,62,3,446
0,846,4,-139,0,60,3,64
1739751055950
1
0,775,4,-139,0,60,3,510
1739751056466
2
0,765,4,-138,0,60,3,72
0,704,4,-139,0,59,3,438
1739751056976
2
0,675,4,-138,0,59,3,208
0,633,4,-139,0,57,3,302
1739751057479
2
0,585,4,-138,0,57,3,345
0,562,4,-139,0,58,3,165
1739751058005
2
0,495,4,-138,0,58,3,482
0,491,4,-139,0,70,3,28
1739751058501
2
0,443,4,-138,0,70,3,345
0,420,4,-139,0,54,3,165
1739751059009
4
0,405,4,-138,0,54,3,108
0,399,4,-138,0,69,3,42
0,387,4,-18,0,69,5,150
0,387,4,0,0,69,5,210
1739751059521
3
0,387,4,0,0,69,5,240
0,405,4,138,0,69,2,180
0,417,4,139,0,54,2,90
1739751060034
2
0,443,4,138,0,54,2,187
0,488,4,139,0,70,2,323
1739751060551
2
0,495,4,138,0,70,2,50
0,559,4,139,0,58,2,460
1739751061050
2
0,585,4,138,0,58,2,187
0,630,4,139,0,57,2,323
1739751061568
2
0,675,4,138,0,57,2,324
0,701,4,139,0,59,2,186
1739751062068
2
0,765,4,138,0,59,2,461
0,772,4,139,0,60,2,49
1739751062580
1
0,843,4,139,0,60,2,510
1739751063097
2
0,855,4,138,0,60,2,86
0,914,4,139,0,62,2,424
1739751063604
2
0,945,4,138,0,62,2,223
0,985,4,139,0,63,2,287
1739751064118
2
0,1035,4,138,0,63,2,360
0,1056,4,139,0,61,2,150
1739751064626
2
0,1125,4,138,0,61,2,497
0,1127,4,139,0,65,2,13
1739751065132
1
0,1198,4,139,0,65,2,510
1739751065648
2
0,1215,4,138,0,65,2,122
0,1269,4,139,0,64,2,388
1739751066154
2
0,1305,4,138,0,64,2,259
0,1340,4,139,0,66,2,251
1739751066659
2
0,1395,4,138,0,66,2,396
0,1411,4,139,0,67,2,114
1739751067181
2
0,1447,4,138,0,67,2,259
0,1482,4,139,0,55,2,251
1739751067684
3
0,1486,4,138,0,55,2,30
0,1497,4,18,0,55,4,150
0,1498,4,0,0,55,4,330
