1739751082984
2
0,1462,-266,0,0,39,5,360
0,1448,-266,-139,0,39,3,150
1739751083489
2
0,1402,-266,-138,0,39,3,331
0,1377,-266,-139,0,49,3,179
1739751084010
2
0,1350,-266,-138,0,49,3,194
0,1306,-266,-139,0,38,3,316
1739751084522
2
0,1260,-266,-138,0,38,3,331
0,1235,-266,-139,0,48,3,179
1739751085021
2
0,1170,-266,-138,0,48,3,468
0,1164,-266,-139,0,45,3,42
1739751085539
1
0,1093,-266,-139,0,45,3,510
1739751086042
2
0,1080,-266,-138,0,45,3,93
0,1022,-266,-139,0,47,3,417
1739751086553
2
0,990,-266,-138,0,47,3,230
0,951,-266,-139,0,46,3,280
1739751087062
2
0,900,-266,-138,0,46,3,367
0,880,-266,-139,0,43,3,143
1739751087568
2
0,810,-266,-138,0,43,3,504
0,809,-266,-139,0,44,3,6
1739751088092
1
0,738,-266,-139,0,44,3,510
1739751088595
2
0,720,-266,-138,0,44,3,129
0,667,-266,-139,0,42,3,381
1739751089099
2
0,630,-266,-138,0,42,3,266
0,596,-266,-139,0,41,3,244
1739751089615
2
0,540,-266,-138,0,41,3,403
0,525,-266,-139,0,53,3,107
1739751090120
2
0,488,-266,-138,0,53,3,266
0,454,-266,-139,0,50,3,244
1739751090638
5
0,450,-266,-138,0,50,3,28
0,437,-266,-138,0,52,3,92
0,425,-266,-18,0,52,5,150
0,425,-266,0,0,52,5,180
0,428,-266,84,0,52,2,60
1739751091142
3
0,450,-266,138,0,52,2,167
0,488,-266,138,0,50,2,273
0,498,-266,139,0,53,2,70
1739751091660
2
0,540,-266,138,0,53,2,302
0,569,-266,139,0,41,2,208
1739751092163
2
0,630,-266,138,0,41,2,439
0,640,-266,139,0,42,2,71
1739751092670
1
0,711,-266,139,0,42,2,510
1739751093187
2
0,720,-266,138,0,42,2,64
0,782,-266,139,0,44,2,446
1739751093692
2
0,810,-266,138,0,44,2,201
0,853,-266,139,0,43,2,309
1739751094201
2
0,900,-266,138,0,43,2,338
0,924,-266,139,0,46,2,172
1739751094725
2
0,990,-266,138,0,46,2,475
0,995,-266,139,0,47,2,35
1739751095221
1
0,1066,-266,139,0,47,2,510
1739751095730
2
0,1080,-266,138,0,47,2,100
0,1137,-266,139,0,45,2,410
1739751096241
2
0,1170,-266,138,0,45,2,237
0,1208,-266,139,0,48,2,273
1739751096749
2
0,1260,-266,138,0,48,2,374
0,1279,-266,139,0,38,2,136
1739751097266
1
0,1350,-266,139,0,38,2,510
1739751097769
3
0,1350,-266,139,0,38,2,0
0,1402,-266,138,0,49,2,374
0,1421,-266,139,0,39,2,136
1739751098280
3
0,1441,-266,138,0,39,2,150
0,1453,-266,18,0,39,4,150
0,1454,-266,0,0,39,4,210
