1739751132962
3
0,1421,-536,0,0,28,5,90
0,1395,-536,-138,0,28,3,237
0,1370,-536,-139,0,27,3,183
1739751133476
3
0,1357,-536,-138,0,27,3,93
0,1305,-536,-138,0,26,3,374
0,1299,-536,-139,0,22,3,43
1739751133983
1
0,1228,-536,-139,0,22,3,510
1739751134494
2
0,1215,-536,-138,0,22,3,93
0,1157,-536,-139,0,25,3,417
1739751135008
2
0,1125,-536,-138,0,25,3,230
0,1086,-536,-139,0,24,3,280
1739751135511
2
0,1035,-536,-138,0,24,3,367
0,1015,-536,-139,0,23,3,143
1739751136022
2
0,945,-536,-138,0,23,3,504
0,944,-536,-139,0,20,3,6
1739751136535
1
0,873,-536,-139,0,20,3,510
1739751137055
2
0,855,-536,-138,0,20,3,129
0,802,-536,-139,0,21,3,381
1739751137567
2
0,765,-536,-138,0,21,3,266
0,731,-536,-139,0,19,3,244
1739751138058
2
0,675,-536,-138,0,19,3,403
0,660,-536,-139,0,18,3,107
1739751138573
1
0,589,-536,-139,0,18,3,510
1739751139079
3
0,585,-536,-138,0,18,3,28
0,533,-536,-138,0,17,3,374
0,518,-536,-139,0,16,3,108
1739751139588
3
0,484,-536,-138,0,16,3,240
0,472,-536,-18,0,16,5,150
0,473,-536,0,0,16,5,120
1739751140102
2
0,473,-536,0,0,16,5,270
0,499,-536,139,0,16,2,240
1739751140608
2
0,533,-536,138,0,16,2,245
0,570,-536,139,0,17,2,265
1739751141119
2
0,585,-536,138,0,17,2,108
0,641,-536,139,0,18,2,402
1739751141633
2
0,675,-536,138,0,18,2,245
0,712,-536,139,0,19,2,265
1739751142138
2
0,765,-536,138,0,19,2,381
0,783,-536,139,0,21,2,129
1739751142656
1
0,854,-536,139,0,21,2,510
1739751143159
2
0,855,-536,138,0,21,2,7
0,925,-536,139,0,20,2,503
1739751143668
2
0,945,-536,138,0,20,2,144
0,996,-536,139,0,23,2,366
1739751144198
2
0,1035,-536,138,0,23,2,281
0,1067,-536,139,0,24,2,229
1739751144693
2
0,1125,-536,138,0,24,2,417
0,1138,-536,139,0,25,2,93
1739751145213
1
0,1209,-536,139,0,25,2,510
1739751145717
2
0,1215,-536,138,0,25,2,43
0,1280,-536,139,0,22,2,467
1739751146222
2
0,1305,-536,138,0,22,2,180
0,1351,-536,139,0,26,2,330
1739751146741
5
0,1357,-536,138,0,26,2,43
0,1395,-536,138,0,27,2,273
0,1396,-536,138,0,28,2,14
0,1408,-536,18,0,28,4,150
0,1409,-536,0,0,28,4,30
