1739751162542
2
0,1380,-806,0,0,1,5,390
0,1370,-806,-139,0,1,3,120
1739751163049
2
0,1312,-806,-138,0,1,3,417
0,1299,-806,-139,0,3,3,93
1739751163562
2
0,1260,-806,-138,0,3,3,281
0,1228,-806,-139,0,4,3,229
1739751164080
2
0,1170,-806,-138,0,4,3,417
0,1157,-806,-139,0,6,3,93
1739751164597
1
0,1086,-806,-139,0,6,3,510
1739751165091
2
0,1080,-806,-138,0,6,3,43
0,1015,-806,-139,0,5,3,467
1739751165600
2
0,990,-806,-138,0,5,3,180
0,944,-806,-139,0,8,3,330
1739751166111
2
0,900,-806,-138,0,8,3,317
0,873,-806,-139,0,9,3,193
1739751166634
2
0,810,-806,-138,0,9,3,454
0,802,-806,-139,0,10,3,56
1739751167143
1
0,731,-806,-139,0,10,3,510
1739751167638
2
0,720,-806,-138,0,10,3,79
0,660,-806,-139,0,11,3,431
1739751168150
2
0,630,-806,-138,0,11,3,216
0,589,-806,-139,0,14,3,294
1739751168661
4
0,578,-806,-138,0,14,3,79
0,540,-806,-138,0,7,3,273
0,534,-806,-138,0,13,3,38
0,524,-806,-43,0,13,5,120
1739751169172
3
0,523,-806,-19,0,13,5,30
0,522,-806,0,0,13,5,330
0,537,-806,139,0,13,2,150
1739751169680
3
0,540,-806,138,0,13,2,21
0,578,-806,138,0,7,2,273
0,608,-806,139,0,14,2,216
1739751170190
2
0,630,-806,138,0,14,2,158
0,679,-806,139,0,11,2,352
1739751170712
2
0,720,-806,138,0,11,2,295
0,750,-806,139,0,10,2,215
1739751171210
2
0,810,-806,138,0,10,2,432
0,821,-806,139,0,9,2,78
1739751171717
1
0,892,-806,139,0,9,2,510
1739751172229
2
0,900,-806,138,0,9,2,57
0,963,-806,139,0,8,2,453
1739751172740
2
0,990,-806,138,0,8,2,194
0,1034,-806,139,0,5,2,316
1739751173250
2
0,1080,-806,138,0,5,2,331
0,1105,-806,139,0,6,2,179
1739751173761
2
0,1170,-806,138,0,6,2,468
0,1176,-806,139,0,4,2,42
1739751174272
1
0,1247,-806,139,0,4,2,510
1739751174795
3
0,1260,-806,138,0,4,2,93
0,1312,-806,138,0,3,2,374
0,1318,-806,139,0,1,2,43
1739751175289
3
0,1359,-806,138,0,1,2,300
0,1371,-806,18,0,1,4,150
0,1372,-806,0,0,1,4,60
