1739751192128
2
0,348,34,0,0,78,5,180
0,309,34,-139,0,78,3,330
1739751192633
2
0,270,34,-138,0,78,3,281
0,238,34,-139,0,79,3,229
1739751193141
2
0,180,34,-138,0,79,3,417
0,167,34,-139,0,80,3,93
1739751193653
1
0,96,34,-139,0,80,3,510
1739751194166
2
0,90,34,-138,0,80,3,43
0,25,34,-139,0,82,3,467
1739751194687
2
0,0,34,-138,0,82,3,180
0,-46,34,-139,0,83,3,330
1739751195179
2
0,-90,34,-138,0,83,3,317
0,-117,34,-139,0,84,3,193
1739751195690
2
0,-180,34,-138,0,84,3,454
0,-188,34,-139,0,85,3,56
1739751196208
1
0,-259,34,-139,0,85,3,510
1739751196719
2
0,-270,34,-138,0,85,3,79
0,-330,34,-139,0,86,3,431
1739751197228
2
0,-360,34,-138,0,86,3,216
0,-401,34,-139,0,99,3,294
1739751197729
2
0,-450,34,-138,0,99,3,353
0,-472,34,-139,0,98,3,157
1739751198242
2
0,-540,34,-138,0,98,3,490
0,-543,34,-139,0,100,3,20
1739751198754
1
0,-614,34,-139,0,100,3,510
1739751199259
3
0,-630,34,-138,0,100,3,115
0,-682,34,-138,0,105,3,374
0,-685,34,-139,0,103,3,21
1739751199788
3
0,-709,34,-138,0,103,3,180
0,-721,34,-18,0,103,5,150
0,-722,34,0,0,103,5,180
1739751200280
2
0,-722,34,0,0,103,5,240
0,-692,34,139,0,103,2,270
1739751200791
3
0,-682,34,138,0,103,2,72
0,-630,34,138,0,105,2,374
0,-621,34,139,0,100,2,64
1739751201306
1
0,-550,34,139,0,100,2,510
1739751201812
2
0,-540,34,138,0,100,2,72
0,-479,34,139,0,98,2,438
1739751202320
2
0,-450,34,138,0,98,2,208
0,-408,34,139,0,99,2,302
1739751202845
2
0,-360,34,138,0,99,2,345
0,-337,34,139,0,86,2,165
1739751203349
2
0,-270,34,138,0,86,2,482
0,-266,34,139,0,85,2,28
1739751203853
1
0,-195,34,139,0,85,2,510
1739751204367
2
0,-180,34,138,0,85,2,108
0,-124,34,139,0,84,2,402
1739751204870
2
0,-90,34,138,0,84,2,245
0,-53,34,139,0,83,2,265
1739751205396
2
0,0,34,138,0,83,2,381
0,18,34,139,0,82,2,129
1739751205890
1
0,89,34,139,0,82,2,510
1739751206400
2
0,90,34,138,0,82,2,7
0,160,34,139,0,80,2,503
1739751206921
2
0,180,34,138,0,80,2,144
0,231,34,139,0,79,2,366
1739751207419
2
0,270,34,138,0,79,2,281
0,302,34,139,0,78,2,229
1739751207938
3
0,351,34,138,0,78,2,360
0,360,34,78,0,78,4,74
0,365,34,31,0,81,4,76
1739751208443
2
0,365,34,7,0,81,4,30
0,366,34,0,0,81,4,480
