1738305882583
2
0,1043,-266,0,0,47,5,450
0,1040,-266,-84,0,47,3,60
1738305883096
4
0,1032,-266,-133,0,47,3,60
0,1021,-266,-13,0,47,5,150
0,1021,-266,0,0,47,5,180
0,1022,-266,0,0,47,11,120
1738305883588
5
1738305884095
3
0,1022,4,0,0,63,5,336
