1738305911142
3
0,640,-536,0,0,18,5,270
0,626,-536,-133,0,18,3,150
0,618,-536,-62,0,18,5,90
1738305911654
8
0,615,-536,-14,0,18,5,60
0,615,-536,0,0,18,5,120
0,615,-536,0,0,18,11,150
1738305912160
3
0,616,-266,0,0,41,5,5
