1738305930523
2
0,981,-536,0,0,23,5,450
0,978,-536,-84,0,23,3,60
1738305931034
4
0,966,-536,-133,0,23,3,90
0,955,-536,-13,0,23,5,150
0,955,-536,0,0,23,5,150
0,956,-536,0,0,23,11,120
1738305931542
5
1738305932049
3
0,956,-266,0,0,46,5,336
