1738305963160
3
0,827,-806,0,0,9,5,270
0,821,-806,-126,0,9,3,90
0,811,-806,-6,0,9,5,150
1738305963670
7
0,810,-806,0,0,9,5,240
0,810,-806,0,0,9,11,120
1738305964168
1
1738305964676
2
0,811,-536,0,0,21,5,485
