1738305980501
2
0,1074,-806,0,0,5,4,420
0,1080,-806,126,0,5,2,90
1738305981013
8
0,1080,-806,126,0,5,4,0
0,1093,-806,6,0,6,4,180
0,1093,-806,0,0,6,4,180
0,1093,-806,0,0,6,10,120
1738305981519
2
1738305982022
3
0,1094,-536,0,0,24,4,366
