1738305860647
2
0,719,-266,0,0,42,5,480
0,718,-266,-42,0,42,3,30
1738305861162
4
0,712,-266,-126,0,42,3,60
0,703,-266,-6,0,42,5,150
0,702,-266,0,0,42,5,240
0,703,-266,0,0,42,11,60
1738305861672
6
0,703,-266,0,0,42,11,90
1738305862178
3
0,703,4,0,0,59,5,246
