1737862513314
3
0,396,4,0,0,69,4,420
0,398,4,84,0,69,2,60
0,401,4,60,0,69,4,30
1737862513821
4
0,403,4,12,0,69,4,60
0,403,4,0,0,69,4,360
0,405,4,64,0,69,2,46
0,408,4,107,0,54,2,44
1737862514343
2
0,443,4,133,0,54,2,264
0,476,4,134,0,70,2,246
1737862514845
2
0,495,4,133,0,70,2,142
0,544,4,134,0,58,2,368
1737862515359
2
0,585,4,133,0,58,2,306
0,612,4,134,0,57,2,204
1737862515864
2
0,675,4,133,0,57,2,470
0,680,4,134,0,59,2,40
1737862516376
1
0,748,4,134,0,59,2,510
1737862516887
2
0,765,4,133,0,59,2,127
0,816,4,134,0,60,2,383
1737862517392
2
0,855,4,133,0,60,2,291
0,884,4,134,0,62,2,219
1737862517905
2
0,945,4,133,0,62,2,456
0,952,4,134,0,63,2,54
1737862518414
1
0,1020,4,134,0,63,2,510
1737862518929
2
0,1035,4,133,0,63,2,112
0,1088,4,134,0,61,2,398
1737862519452
2
0,1125,4,133,0,61,2,276
0,1156,4,134,0,65,2,234
1737862519960
2
0,1215,4,133,0,65,2,441
0,1224,4,134,0,64,2,69
1737862520457
1
0,1292,4,134,0,64,2,510
1737862520964
3
0,1305,4,133,0,64,2,97
0,1356,4,133,0,66,2,383
0,1360,4,110,0,66,4,30
1737862521476
2
0,1367,4,14,0,66,4,120
0,1368,4,0,0,66,4,390
1737862521985
5
0,1368,4,0,0,66,4,120
0,1362,4,-126,0,66,3,90
0,1352,4,-6,0,66,5,150
0,1352,4,0,0,66,5,60
0,1347,4,-126,0,66,3,90
1737862522492
2
0,1305,4,-133,0,66,3,314
0,1279,4,-134,0,64,3,196
1737862523003
2
0,1215,4,-133,0,64,3,478
0,1211,4,-134,0,65,3,32
1737862523527
1
0,1143,4,-134,0,65,3,510
1737862524022
2
0,1125,4,-133,0,65,3,134
0,1075,4,-134,0,61,3,376
1737862524540
2
0,1035,4,-133,0,61,3,299
0,1007,4,-134,0,63,3,211
1737862525042
2
0,945,4,-133,0,63,3,463
0,939,4,-134,0,62,3,47
1737862525552
1
0,871,4,-134,0,62,3,510
1737862526064
2
0,855,4,-133,0,62,3,119
0,803,4,-134,0,60,3,391
1737862526576
2
0,765,4,-133,0,60,3,284
0,735,4,-134,0,59,3,226
1737862527090
2
0,675,4,-133,0,59,3,448
0,667,4,-134,0,57,3,62
1737862527595
1
0,599,4,-134,0,57,3,510
1737862528105
2
0,585,4,-133,0,57,3,104
0,531,4,-134,0,58,3,406
1737862528621
2
0,495,4,-133,0,58,3,269
0,463,4,-134,0,70,3,241
1737862529131
4
0,443,4,-133,0,70,3,149
0,422,4,-133,0,54,3,151
0,411,4,-13,0,54,5,150
0,412,4,0,0,54,5,60
