1737880949648
4
0,487,-536,133,0,16,2,120
0,498,-536,13,0,16,4,150
0,498,-536,0,0,16,4,180
0,501,-536,84,0,16,2,60
1737880950162
2
0,533,-536,133,0,16,2,246
0,568,-536,134,0,17,2,264
1737880950670
2
0,585,-536,133,0,17,2,127
0,636,-536,134,0,18,2,383
1737880951178
2
0,675,-536,133,0,18,2,291
0,704,-536,134,0,19,2,219
1737880951692
2
0,765,-536,133,0,19,2,456
0,772,-536,134,0,21,2,54
1737880952216
1
0,840,-536,134,0,21,2,510
1737880952707
2
0,855,-536,133,0,21,2,112
0,908,-536,134,0,20,2,398
1737880953237
2
0,945,-536,133,0,20,2,276
0,976,-536,134,0,23,2,234
1737880953747
2
0,1035,-536,133,0,23,2,441
0,1044,-536,134,0,24,2,69
1737880954254
1
0,1112,-536,134,0,24,2,510
1737880954750
2
0,1125,-536,133,0,24,2,97
0,1180,-536,134,0,25,2,413
1737880955256
2
0,1215,-536,133,0,25,2,261
0,1248,-536,134,0,22,2,249
1737880955767
3
0,1268,-536,133,0,22,2,150
0,1279,-536,13,0,22,4,150
0,1279,-536,0,0,22,4,210
1737880956279
2
0,1279,-536,0,0,22,4,120
0,1233,-536,-134,0,22,3,390
1737880956793
2
0,1215,-536,-133,0,22,3,134
0,1165,-536,-134,0,25,3,376
1737880957297
2
0,1125,-536,-133,0,25,3,299
0,1097,-536,-134,0,24,3,211
1737880957807
2
0,1035,-536,-133,0,24,3,463
0,1029,-536,-134,0,23,3,47
1737880958329
1
0,961,-536,-134,0,23,3,510
1737880958829
2
0,945,-536,-133,0,23,3,119
0,893,-536,-134,0,20,3,391
1737880959336
2
0,855,-536,-133,0,20,3,284
0,825,-536,-134,0,21,3,226
1737880959849
2
0,765,-536,-133,0,21,3,448
0,757,-536,-134,0,19,3,62
1737880960357
1
0,689,-536,-134,0,19,3,510
1737880960875
2
0,675,-536,-133,0,19,3,104
0,621,-536,-134,0,18,3,406
1737880961379
2
0,585,-536,-133,0,18,3,269
0,553,-536,-134,0,17,3,241
1737880961886
4
0,533,-536,-133,0,17,3,149
0,528,-536,-133,0,16,3,31
0,517,-536,-13,0,16,5,150
0,518,-536,0,0,16,5,180
