1737957990269
3
0,640,-806,0,0,11,4,120
0,640,-806,0,0,11,4,390
1737957990784
2
0,640,-806,0,0,11,4,390
0,649,-806,126,0,11,2,120
1737957991305
1
0,713,-806,126,0,11,2,510
1737957991799
2
0,720,-806,126,0,11,2,55
0,777,-806,126,0,10,2,455
1737957992311
2
0,810,-806,126,0,10,2,261
0,841,-806,126,0,9,2,249
1737957992820
2
0,900,-806,126,0,9,2,467
0,905,-806,126,0,8,2,43
1737957993331
1
0,969,-806,126,0,8,2,510
1737957993846
2
0,990,-806,126,0,8,2,166
0,1033,-806,126,0,5,2,344
1737957994349
2
0,1080,-806,126,0,5,2,372
0,1097,-806,126,0,6,2,138
1737957994859
1
0,1161,-806,126,0,6,2,510
1737957995370
2
0,1170,-806,126,0,6,2,71
0,1225,-806,126,0,4,2,439
1737957995878
4
0,1228,-806,126,0,4,2,30
0,1238,-806,6,0,4,4,150
0,1238,-806,0,0,4,4,240
0,1233,-806,-126,0,4,3,90
1737957996396
2
0,1170,-806,-126,0,4,3,499
0,1169,-806,-126,0,6,3,11
1737957996899
1
0,1105,-806,-126,0,6,3,510
1737957997407
2
0,1080,-806,-126,0,6,3,198
0,1041,-806,-126,0,5,3,312
1737957997927
2
0,990,-806,-126,0,5,3,403
0,976,-806,-126,0,8,3,107
1737957998432
1
0,912,-806,-126,0,8,3,510
1737957998939
2
0,900,-806,-126,0,8,3,95
0,848,-806,-126,0,9,3,415
1737957999447
2
0,810,-806,-126,0,9,3,301
0,784,-806,-126,0,10,3,209
1737957999959
2
0,720,-806,-126,0,10,3,506
0,719,-806,-126,0,11,3,4
1737958000481
1
0,655,-806,-126,0,11,3,510
1737958000981
2
0,645,-806,-6,0,11,5,150
0,645,-806,0,0,11,5,360
