1737882970798
4
0,436,-266,0,0,52,4,300
0,449,-266,135,0,52,2,150
0,450,-266,132,0,52,4,2
0,457,-266,109,0,50,4,58
1737882971322
5
0,462,-266,61,0,50,4,60
0,464,-266,13,0,50,4,60
0,464,-266,0,0,50,4,180
0,486,-266,136,0,50,2,210
1737882971815
3
0,488,-266,136,0,50,2,14
0,540,-266,136,0,53,2,381
0,556,-266,136,0,41,2,115
1737882972340
2
0,625,-266,135,0,41,2,510
1737882972838
4
0,630,-266,135,0,41,2,37
0,685,-266,135,0,42,2,413
0,694,-266,136,0,42,2,60
1737882973356
2
0,720,-266,136,0,42,2,190
0,764,-266,136,0,44,2,320
1737882973857
4
0,810,-266,136,0,44,2,337
0,821,-266,136,0,43,2,83
0,825,-266,112,0,43,4,30
0,833,-266,136,0,43,2,60
1737882974374
4
0,841,-266,136,0,43,2,60
0,900,-266,135,0,43,2,435
0,902,-266,135,0,46,2,15
1737882974880
2
0,966,-266,135,0,46,2,480
0,970,-266,111,0,46,4,30
1737882975396
5
0,972,-266,87,0,46,4,30
0,984,-266,135,0,46,2,90
0,990,-266,136,0,46,2,42
0,1037,-266,136,0,47,2,348
1737882975896
2
0,1080,-266,136,0,47,2,315
0,1107,-266,136,0,45,2,195
1737882976423
6
0,1123,-266,136,0,45,2,120
0,1127,-266,112,0,45,4,30
0,1143,-266,136,0,45,2,120
0,1170,-266,135,0,45,2,199
0,1176,-266,135,0,48,2,41
1737882976928
1
0,1245,-266,135,0,48,2,510
1737882977429
6
0,1260,-266,135,0,48,2,111
0,1293,-266,135,0,38,2,249
0,1297,-266,111,0,38,4,30
0,1309,-266,135,0,38,2,90
0,1313,-266,136,0,38,2,30
1737882977937
4
0,1350,-266,136,0,38,2,271
0,1353,-266,136,0,49,2,29
0,1365,-266,16,0,49,4,150
0,1366,-266,0,0,49,4,60
1737882978450
3
0,1366,-266,0,0,49,4,300
0,1350,-266,-136,0,49,3,166
0,1344,-266,-136,0,38,3,44
1737882978956
1
0,1275,-266,-136,0,38,3,510
1737882979473
2
0,1260,-266,-136,0,38,3,110
0,1206,-266,-136,0,48,3,400
1737882979982
4
0,1201,-266,-136,0,48,3,30
0,1170,-266,-135,0,48,3,236
0,1137,-266,-135,0,45,3,244
1737882980497
2
0,1080,-266,-135,0,45,3,422
0,1068,-266,-135,0,47,3,88
1737882981013
3
0,1047,-266,-135,0,47,3,150
0,999,-266,-136,0,47,3,360
1737882981516
2
0,990,-266,-136,0,47,3,66
0,930,-266,-136,0,46,3,444
1737882982014
4
0,900,-266,-136,0,46,3,220
0,876,-266,-136,0,43,3,170
0,861,-266,-135,0,43,3,120
1737882982541
2
0,810,-266,-135,0,43,3,377
0,792,-266,-135,0,44,3,133
1737882983037
5
0,747,-266,-135,0,44,3,330
0,743,-266,-111,0,44,5,30
0,727,-266,-135,0,44,3,120
0,724,-266,-136,0,44,3,30
1737882983548
2
0,720,-266,-136,0,44,3,29
0,654,-266,-136,0,42,3,481
1737882984072
6
0,630,-266,-136,0,42,3,176
0,609,-266,-136,0,41,3,154
0,605,-266,-112,0,41,5,30
0,589,-266,-136,0,41,3,120
0,585,-266,-135,0,41,3,30
1737882984582
2
0,540,-266,-135,0,41,3,333
0,516,-266,-135,0,53,3,177
1737882985094
5
0,488,-266,-135,0,53,3,207
0,467,-266,-135,0,50,3,153
0,458,-266,-63,0,50,5,90
0,456,-266,-15,0,50,5,60
1737882985605
1
0,456,-266,0,0,50,5,510
