1740259078868
7
0,-487,-108,0,0,61,5,150
0,-487,-108,0,0,61,5,30
0,-516,99,0,180,0,7,90
0,-516,102,0,0,0,7,15
0,-516,102,0,0,68,5,225
1740259079378
3
0,-516,102,0,0,68,5,300
0,-516,102,0,0,68,5,210
