1740258992165
2
0,-1453,-128,0,0,51,5,450
0,-1453,-134,0,0,-1,15,60
1740258992678
1
0,-1453,-185,0,0,-1,15,510
1740258993183
1
0,-1453,-236,0,0,-1,15,510
1740258993697
1
0,-1453,-287,0,0,-1,15,510
1740258994209
5
0,-1453,-321,0,0,-1,15,270
0,-1453,-321,0,0,0,7,30
0,-1453,-320,0,60,0,7,30
0,-1453,-318,0,0,0,7,20
0,-1453,-318,0,0,28,5,160
