1740255719753
3
0,-179,102,0,0,76,5,420
0,-180,102,-50,0,76,3,35
0,-183,102,-92,0,75,3,55
1740255720265
2
0,-213,102,-146,0,75,3,213
0,-256,102,-146,0,66,3,297
1740255720779
2
0,-270,102,-146,0,66,3,95
0,-331,102,-146,0,70,3,415
1740255721285
2
0,-360,102,-146,0,70,3,198
0,-406,102,-146,0,69,3,312
1740255721797
2
0,-450,102,-146,0,69,3,300
0,-481,102,-146,0,68,3,210
1740255722309
2
0,-540,102,-146,0,68,3,403
0,-556,102,-146,0,72,3,107
1740255722817
2
0,-630,102,-146,0,72,3,506
0,-631,102,-146,0,73,3,4
1740255723326
1
0,-706,102,-146,0,73,3,510
1740255723838
2
0,-720,102,-146,0,73,3,95
0,-781,102,-146,0,71,3,415
1740255724345
2
0,-810,102,-146,0,71,3,198
0,-856,102,-146,0,67,3,312
1740255724858
2
0,-900,102,-146,0,67,3,300
0,-931,102,-146,0,74,3,210
1740255725367
2
0,-990,102,-146,0,74,3,403
0,-1006,102,-146,0,81,3,107
1740255725878
2
0,-1080,102,-146,0,81,3,506
0,-1081,102,-146,0,82,3,4
1740255726390
1
0,-1156,102,-146,0,82,3,510
1740255726896
2
0,-1170,102,-146,0,82,3,95
0,-1231,102,-146,0,83,3,415
1740255727406
2
0,-1260,102,-146,0,83,3,198
0,-1306,102,-146,0,84,3,312
1740255727901
2
0,-1350,102,-146,0,84,3,300
0,-1381,102,-146,0,85,3,210
1740255728414
2
0,-1440,102,-146,0,85,3,403
0,-1456,102,-146,0,88,3,107
1740255728931
2
0,-1530,102,-146,0,88,3,506
0,-1531,102,-146,0,87,3,4
1740255729442
1
0,-1606,102,-146,0,87,3,510
1740255729956
2
0,-1620,102,-146,0,87,3,95
0,-1681,102,-146,0,86,3,415
1740255730467
2
0,-1710,102,-146,0,86,3,198
0,-1756,102,-146,0,89,3,312
1740255730976
2
0,-1800,102,-146,0,89,3,300
0,-1831,102,-146,0,94,3,210
1740255731487
5
0,-1857,102,-146,0,94,3,177
0,-1888,102,-146,0,90,3,213
0,-1890,102,-135,0,90,5,13
0,-1892,102,-135,0,93,5,17
0,-1893,102,0,0,93,5,90
1740255731996
2
0,-1893,102,0,0,93,5,450
0,-1890,102,84,0,93,2,60
1740255732509
3
0,-1890,102,84,0,93,2,0
0,-1857,102,146,0,90,2,248
0,-1819,102,146,0,94,2,262
1740255733017
2
0,-1800,102,146,0,94,2,129
0,-1744,102,146,0,89,2,381
1740255733512
2
0,-1710,102,146,0,89,2,232
0,-1669,102,146,0,86,2,278
1740255734040
2
0,-1620,102,146,0,86,2,335
0,-1594,102,146,0,87,2,175
1740255734547
2
0,-1530,102,146,0,87,2,437
0,-1519,102,146,0,88,2,73
1740255735059
1
0,-1444,102,146,0,88,2,510
1740255735569
2
0,-1440,102,146,0,88,2,27
0,-1369,102,146,0,85,2,483
1740255736077
2
0,-1350,102,146,0,85,2,129
0,-1294,102,146,0,84,2,381
1740255736584
2
0,-1260,102,146,0,84,2,232
0,-1219,102,146,0,83,2,278
1740255737097
2
0,-1170,102,146,0,83,2,335
0,-1144,102,146,0,82,2,175
1740255737606
2
0,-1080,102,146,0,82,2,437
0,-1069,102,146,0,81,2,73
1740255738135
1
0,-994,102,146,0,81,2,510
1740255738613
2
0,-990,102,146,0,81,2,27
0,-919,102,146,0,74,2,483
1740255739125
2
0,-900,102,146,0,74,2,129
0,-844,102,146,0,67,2,381
1740255739650
2
0,-810,102,146,0,67,2,232
0,-769,102,146,0,71,2,278
1740255740160
2
0,-720,102,146,0,71,2,335
0,-694,102,146,0,73,2,175
1740255740666
2
0,-630,102,146,0,73,2,437
0,-619,102,146,0,72,2,73
1740255741177
1
0,-544,102,146,0,72,2,510
1740255741689
2
0,-540,102,146,0,72,2,27
0,-469,102,146,0,68,2,483
1740255742197
2
0,-450,102,146,0,68,2,129
0,-394,102,146,0,69,2,381
1740255742709
2
0,-360,102,146,0,69,2,232
0,-319,102,146,0,70,2,278
1740255743205
2
0,-270,102,146,0,70,2,335
0,-244,102,146,0,66,2,175
1740255743728
4
0,-213,102,146,0,66,2,211
0,-180,102,146,0,75,2,225
0,-177,102,146,0,76,2,14
0,-177,102,0,0,76,2,60
1740255744238
1
0,-177,102,0,0,76,4,510
