1740259029907
7
0,-446,-318,0,0,37,5,210
0,-446,-318,0,0,37,5,30
0,-491,-109,0,180,0,7,90
0,-491,-108,0,0,0,7,10
0,-491,-108,0,0,61,5,170
