1777351815745
2
0,-310,-32,0,0,204,4,180
0,-255,-32,175,0,204,2,330
1777351816259
1
0,-166,-32,175,0,204,2,510
1777351816787
1
0,-77,-32,175,0,204,2,510
1777351817294
1
0,12,-32,175,0,204,2,510
1777351817803
1
0,101,-32,175,0,204,2,510
1777351818313
1
0,190,-32,175,0,204,2,510
1777351818811
3
0,216,-32,175,0,204,2,150
0,220,-32,0,0,204,2,210
0,220,-32,0,0,204,4,150
1777351819847
2
0,220,-32,0,0,204,4,30
0,139,-32,-175,0,204,3,480
1777351820354
1
0,50,-32,-175,0,204,3,510
1777351820867
1
0,-39,-32,-175,0,204,3,510
1777351821360
1
0,-128,-32,-175,0,204,3,510
1777351821874
1
0,-217,-32,-175,0,204,3,510
1777351822390
1
0,-306,-32,-175,0,204,3,510
1777351822899
2
0,-310,-32,0,0,204,3,180
0,-310,-32,0,0,204,5,330
