1740258928417
7
0,-1747,102,0,0,89,5,120
0,-1747,102,0,0,89,5,30
0,-1752,-110,0,180,0,7,90
0,-1752,-108,0,0,0,7,15
0,-1752,-108,0,0,64,5,255
