1740259090093
3
0,-769,-108,0,0,43,5,390
0,-769,-106,0,0,43,11,30
0,-769,-97,0,0,-3,15,90
1740259090603
1
0,-769,-46,0,0,-3,15,510
1740259091110
1
0,-769,5,0,0,-3,15,510
1740259091616
1
0,-769,56,0,0,-3,15,510
1740259092130
5
0,-769,83,0,0,-3,15,240
0,-769,83,0,0,0,7,30
0,-769,97,0,240,0,7,120
0,-769,102,0,0,0,7,16
0,-769,102,0,0,71,5,104
