1740255993130
2
0,-473,-108,0,0,61,5,300
0,-496,-108,-146,0,61,3,210
1740255993641
4
0,-500,-109,-146,0,61,3,30
0,-544,-215,-146,-54,0,7,300
0,-571,-193,-146,305,0,7,180
1740255994155
4
0,-592,-124,-146,605,0,7,150
0,-596,-108,-73,0,0,7,26
0,-618,-108,-146,0,57,3,166
0,-643,-108,-146,0,56,3,168
1740255994664
2
0,-675,-108,-146,0,56,3,218
0,-718,-108,-146,0,44,3,292
1740255995172
2
0,-765,-108,-146,0,44,3,321
0,-793,-108,-146,0,43,3,189
1740255995681
2
0,-855,-108,-146,0,43,3,423
0,-868,-108,-146,0,42,3,87
1740255996193
1
0,-943,-108,-146,0,42,3,510
1740255996701
2
0,-945,-108,-146,0,42,3,13
0,-1018,-108,-146,0,45,3,497
1740255997212
2
0,-1035,-108,-146,0,45,3,116
0,-1093,-108,-146,0,47,3,394
1740255997721
2
0,-1125,-108,-146,0,47,3,218
0,-1168,-108,-146,0,48,3,292
1740255998223
2
0,-1215,-108,-146,0,48,3,321
0,-1243,-108,-146,0,46,3,189
1740255998734
2
0,-1305,-108,-146,0,46,3,423
0,-1318,-108,-146,0,50,3,87
1740255999246
1
0,-1393,-108,-146,0,50,3,510
1740255999759
2
0,-1395,-108,-146,0,50,3,13
0,-1468,-108,-146,0,51,3,497
1740256000273
2
0,-1485,-108,-146,0,51,3,116
0,-1543,-108,-146,0,49,3,394
1740256000779
2
0,-1575,-108,-146,0,49,3,218
0,-1618,-108,-146,0,55,3,292
1740256001289
4
0,-1632,-108,-146,0,55,3,95
0,-1661,-109,-146,0,52,3,205
0,-1693,-202,-146,-235,0,7,210
1740256001800
4
0,-1706,-215,-145,-55,0,7,90
0,-1754,-124,-145,605,0,7,330
0,-1758,-108,-72,0,0,7,25
0,-1761,-108,-25,0,64,5,65
1740256002303
2
0,-1761,-108,-1,0,64,5,30
0,-1761,-108,0,0,64,5,480
1740256002823
2
0,-1761,-108,0,0,64,5,450
0,-1758,-108,84,0,64,2,60
1740256003326
4
0,-1750,-109,146,0,64,2,60
0,-1706,-215,146,-54,0,6,300
0,-1685,-201,146,245,0,6,150
1740256003843
4
0,-1658,-124,146,605,0,6,180
0,-1654,-108,73,0,0,6,25
0,-1632,-108,146,0,52,2,166
0,-1612,-108,146,0,55,2,139
1740256004352
2
0,-1575,-108,146,0,55,2,253
0,-1537,-108,146,0,49,2,257
1740256004863
2
0,-1485,-108,146,0,49,2,355
0,-1462,-108,146,0,51,2,155
1740256005375
2
0,-1395,-108,146,0,51,2,458
0,-1387,-108,146,0,50,2,52
1740256005884
1
0,-1312,-108,146,0,50,2,510
1740256006395
2
0,-1305,-108,146,0,50,2,47
0,-1237,-108,146,0,46,2,463
1740256006904
2
0,-1215,-108,146,0,46,2,150
0,-1162,-108,146,0,48,2,360
1740256007408
2
0,-1125,-108,146,0,48,2,253
0,-1087,-108,146,0,47,2,257
1740256007923
2
0,-1035,-108,146,0,47,2,355
0,-1012,-108,146,0,45,2,155
1740256008432
2
0,-945,-108,146,0,45,2,458
0,-937,-108,146,0,42,2,52
1740256008941
1
0,-862,-108,146,0,42,2,510
1740256009453
2
0,-855,-108,146,0,42,2,47
0,-787,-108,146,0,43,2,463
1740256009963
2
0,-765,-108,146,0,43,2,150
0,-712,-108,146,0,44,2,360
1740256010472
2
0,-675,-108,146,0,44,2,253
0,-637,-108,146,0,56,2,257
1740256010983
4
0,-618,-108,146,0,56,2,129
0,-588,-109,146,0,57,2,201
0,-562,-194,146,-295,0,6,180
1740256011493
4
0,-544,-215,146,-55,0,6,120
0,-496,-124,145,605,0,6,330
0,-492,-108,72,0,0,6,25
0,-490,-108,49,0,61,4,35
1740256012005
2
0,-488,-108,1,0,61,4,60
0,-488,-108,0,0,61,4,450
