1739835219209
4
0,-170,34,0,0,66,5,270
0,-179,34,-138,0,66,3,120
0,-180,34,-136,0,66,5,2
0,-193,34,-64,0,65,5,118
1739835219723
3
0,-195,34,-16,0,65,5,60
0,-192,32,0,0,65,5,0
0,-192,-13,0,0,-4,15,450
1739835220229
1
0,-192,-64,0,0,-4,15,510
1739835220742
1
0,-192,-115,0,0,-4,15,510
1739835221264
1
0,-192,-166,0,0,-4,15,510
1739835221757
5
0,-192,-209,0,0,-4,15,360
0,-192,-209,0,0,0,7,30
0,-192,-208,0,60,0,7,30
0,-192,-206,0,0,0,7,20
0,-192,-206,0,0,22,5,70
