1739835284997
6
0,335,-206,0,0,26,4,210
0,344,-206,138,0,26,2,120
0,348,-206,114,0,26,4,30
0,351,-206,90,0,26,10,30
0,358,-204,0,0,26,10,0
0,358,-192,0,0,-3,14,120
1739835285512
1
0,358,-141,0,0,-3,14,510
1739835286018
1
0,358,-90,0,0,-3,14,510
1739835286529
1
0,358,-39,0,0,-3,14,510
1739835287039
1
0,358,12,0,0,-3,14,510
1739835287549
4
0,358,33,0,0,-3,14,180
0,358,34,0,0,0,6,60
0,358,34,0,0,63,10,30
0,358,34,0,0,63,4,240
