1739835372720
2
0,105,-416,0,0,6,4,450
0,108,-416,84,0,6,2,60
1739835373229
4
0,112,-416,12,0,6,4,90
0,112,-416,0,0,6,4,300
0,118,-414,0,0,6,10,30
0,118,-405,0,0,-1,14,90
1739835373741
1
0,118,-354,0,0,-1,14,510
1739835374248
1
0,118,-303,0,0,-1,14,510
1739835374757
1
0,118,-252,0,0,-1,14,510
1739835375272
3
0,118,-207,0,0,-1,14,420
0,118,-206,0,0,0,6,60
0,118,-206,0,0,27,10,30
1739835375777
1
0,118,-206,0,0,27,4,510
