1739835387509
3
0,648,-416,0,0,2,4,330
0,661,-416,138,0,2,2,150
0,666,-416,115,0,2,4,30
1739835388018
8
0,674,-416,19,0,2,4,120
0,674,-416,0,0,2,4,90
0,674,-416,0,0,2,4,30
0,423,-206,0,240,0,6,120
0,423,-206,0,0,0,6,3
0,423,-206,0,0,19,4,147
