1739835477270
2
0,561,-26,0,0,35,5,450
0,558,-26,-84,0,35,3,60
1739835477780
4
0,540,-26,-138,0,35,3,138
0,502,-26,-138,0,37,3,273
0,500,-26,-138,0,0,7,9
0,488,-18,-139,180,0,7,90
1739835478290
5
0,467,31,-139,480,0,7,150
0,466,34,-69,0,0,7,4
0,450,34,-138,0,58,3,141
0,436,34,-138,0,62,3,95
0,426,34,-43,0,62,5,120
1739835478803
2
0,425,34,-19,0,62,5,30
0,425,34,0,0,62,5,480
