1739835092732
2
0,-261,-416,0,0,9,4,120
0,-214,-416,139,0,9,2,390
1739835093241
2
0,-187,-416,138,0,9,2,194
0,-143,-416,139,0,11,2,316
1739835093757
2
0,-135,-416,138,0,11,2,57
0,-72,-416,139,0,3,2,453
1739835094260
2
0,-45,-416,138,0,3,2,194
0,-1,-416,139,0,4,2,316
1739835094769
2
0,45,-416,138,0,4,2,331
0,70,-416,139,0,6,2,179
1739835095283
2
0,135,-416,138,0,6,2,468
0,141,-416,139,0,5,2,42
1739835095791
1
0,212,-416,139,0,5,2,510
1739835096300
2
0,225,-416,138,0,5,2,93
0,283,-416,139,0,7,2,417
1739835096808
2
0,315,-416,138,0,7,2,230
0,354,-416,139,0,15,2,280
1739835097318
2
0,405,-416,138,0,15,2,367
0,425,-416,139,0,10,2,143
1739835097834
2
0,495,-416,138,0,10,2,504
0,496,-416,139,0,1,2,6
1739835098342
1
0,567,-416,139,0,1,2,510
1739835098848
2
0,585,-416,138,0,1,2,129
0,638,-416,139,0,2,2,381
1739835099360
2
0,675,-416,138,0,2,2,266
0,709,-416,139,0,14,2,244
1739835099874
2
0,727,-416,138,0,14,2,129
0,780,-416,139,0,12,2,381
1739835100395
3
0,784,-416,138,0,12,2,30
0,795,-416,18,0,12,4,150
0,796,-416,0,0,12,4,330
1739835100895
1
0,732,-416,-139,0,12,3,510
1739835101407
3
0,727,-416,-138,0,12,3,36
0,675,-416,-138,0,14,3,374
0,661,-416,-139,0,2,3,100
1739835101914
1
0,590,-416,-139,0,2,3,510
1739835102418
2
0,585,-416,-138,0,2,3,36
0,519,-416,-139,0,1,3,474
1739835102933
2
0,495,-416,-138,0,1,3,172
0,448,-416,-139,0,10,3,338
1739835103440
2
0,405,-416,-138,0,10,3,309
0,377,-416,-139,0,15,3,201
1739835103948
2
0,315,-416,-138,0,15,3,446
0,306,-416,-139,0,7,3,64
1739835104461
1
0,235,-416,-139,0,7,3,510
1739835104967
2
0,225,-416,-138,0,7,3,72
0,164,-416,-139,0,5,3,438
1739835105477
2
0,135,-416,-138,0,5,3,208
0,93,-416,-139,0,6,3,302
1739835105991
2
0,45,-416,-138,0,6,3,345
0,22,-416,-139,0,4,3,165
1739835106500
2
0,-45,-416,-138,0,4,3,482
0,-49,-416,-139,0,3,3,28
1739835107011
1
0,-120,-416,-139,0,3,3,510
1739835107523
3
0,-135,-416,-138,0,3,3,108
0,-187,-416,-138,0,11,3,374
0,-191,-416,-139,0,9,3,28
1739835108027
3
0,-228,-416,-138,0,9,3,270
0,-240,-416,-18,0,9,5,150
0,-241,-416,0,0,9,5,90
