1778963118350
5
0,-43,-128,0,0,4,4,150
0,-43,-215,0,-306,0,6,180
0,-44,-238,-8,-6,0,7,150
0,-44,-238,-9,54,0,7,30
1778963118869
3
0,-44,-235,-8,114,0,7,30
0,-43,-235,0,0,0,7,0
0,-43,-283,0,0,-1,17,480
1778963119382
6
0,-43,-325,0,0,-1,17,360
0,-43,-325,0,0,0,7,30
0,-43,-324,0,60,0,7,30
0,-43,-322,5,0,0,7,13
0,-42,-322,5,0,208,5,17
0,-43,-323,0,0,208,5,60
1778963119877
4
0,-43,-322,0,0,208,5,30
0,-61,-325,-173,-23,208,3,120
0,-70,-326,-30,-4,208,5,90
0,-71,-326,0,0,208,5,270
