1778966974982
6
0,-1531,-127,0,0,18,5,30
0,-1517,-127,175,0,18,2,90
0,-1513,-127,127,0,18,4,30
0,-1519,-127,-175,0,18,3,60
0,-1528,-127,-31,0,18,5,90
0,-1529,-127,0,0,18,5,210
1778966975473
6
0,-1529,-128,0,0,18,5,0
0,-1529,-238,0,-6,0,7,330
0,-1529,-238,0,54,0,7,30
0,-1530,-238,0,0,0,7,0
0,-1530,-253,0,0,-10,17,150
1778966975987
1
0,-1530,-304,0,0,-10,17,510
1778966976513
1
0,-1530,-355,0,0,-10,17,510
1778966977009
1
0,-1530,-406,0,0,-10,17,510
1778966977532
1
0,-1530,-457,0,0,-10,17,510
1778966978040
1
0,-1530,-496,0,0,-10,17,510
1778966978551
6
0,-1530,-496,0,0,-10,17,90
0,-1564,-523,-227,-33,0,7,180
0,-1591,-513,-227,207,0,7,120
0,-1598,-513,0,0,0,7,0
0,-1598,-525,0,0,-9,17,120
1778966979049
3
0,-1598,-555,0,0,-9,17,330
0,-1632,-582,-227,-33,0,7,180
1778966979561
4
0,-1693,-518,-226,507,0,7,270
0,-1696,-511,-113,0,0,7,13
0,-1701,-511,-17,0,213,5,77
0,-1702,-511,0,0,213,5,150
1778966980593
7
0,-1702,-511,0,0,213,5,90
0,-1709,-512,-175,0,213,3,60
0,-1767,-622,-174,-6,0,7,330
0,-1772,-622,-174,54,0,7,30
0,-1777,-622,0,0,0,7,0
0,-1777,-622,0,0,-8,17,0
1778966981091
1
0,-1777,-673,0,0,-8,17,510
1778966981611
1
0,-1777,-724,0,0,-8,17,510
1778966982105
1
0,-1777,-775,0,0,-8,17,510
1778966982631
3
0,-1777,-817,0,0,-8,17,420
0,-1791,-833,-239,-200,0,7,90
1778966983127
2
0,-1812,-842,-238,-20,0,7,90
0,-1912,-681,-230,670,0,7,420
1778966983652
2
0,-1918,-660,-227,670,0,7,30
0,-2005,-339,-131,670,0,6,480
1778966984148
5
0,-2035,-137,-71,670,0,6,300
0,-2036,-127,0,0,0,6,16
0,-2036,-127,0,0,29,2,14
0,-2025,-127,175,0,29,2,77
0,-2007,-127,175,0,27,2,103
1778966984661
2
0,-1935,-127,175,0,27,2,411
0,-1918,-127,175,0,38,2,99
1778966985184
2
0,-1845,-127,175,0,38,2,417
0,-1829,-127,175,0,19,2,93
1778966985689
2
0,-1755,-127,175,0,19,2,422
0,-1740,-127,175,0,21,2,88
1778966986186
2
0,-1665,-127,175,0,21,2,428
0,-1651,-127,175,0,20,2,82
1778966986713
3
0,-1603,-128,175,0,20,2,270
0,-1562,-230,175,-186,0,6,240
1778966987208
4
0,-1546,-238,174,-6,0,6,90
0,-1535,-235,174,114,0,6,60
0,-1530,-235,0,0,0,6,0
0,-1530,-250,0,0,-10,16,360
1778966987734
1
0,-1530,-292,0,0,-10,16,510
1778966988233
1
0,-1530,-343,0,0,-10,16,510
1778966988750
1
0,-1530,-394,0,0,-10,16,510
1778966989261
1
0,-1530,-445,0,0,-10,16,510
1778966989761
3
0,-1530,-487,0,0,-10,16,420
0,-1544,-503,-227,-213,0,7,90
1778966990269
4
0,-1564,-514,-227,-33,0,7,90
0,-1591,-503,-227,207,0,7,120
0,-1598,-503,0,0,0,7,0
0,-1598,-534,0,0,-9,17,300
1778966990776
4
0,-1598,-549,0,0,-9,17,150
0,-1632,-576,-227,-33,0,7,180
0,-1673,-550,-227,327,0,7,180
1778966991290
5
0,-1693,-512,-227,507,0,7,90
0,-1693,-511,-113,0,0,7,1
0,-1716,-512,-175,0,213,3,149
0,-1764,-619,-175,-126,0,7,270
1778966991805
4
0,-1774,-622,-174,-6,0,7,60
0,-1779,-622,-174,54,0,7,30
0,-1777,-622,0,0,0,7,0
0,-1777,-634,0,0,-8,17,420
1778966992311
1
0,-1777,-628,0,0,-8,17,510
1778966992831
1
0,-1777,-655,0,0,-8,17,510
1778966993325
1
0,-1777,-706,0,0,-8,17,510
1778966993855
1
0,-1777,-757,0,0,-8,17,510
1778966994357
1
0,-1777,-808,0,0,-8,17,510
1778966994874
1
0,-1777,-859,0,0,-8,17,510
1778966995383
3
0,-1777,-910,0,0,-8,17,450
0,-1777,-910,0,0,0,7,30
0,-1777,-909,0,60,0,7,30
1778966995881
6
0,-1777,-907,0,0,0,7,20
0,-1777,-907,0,0,150,5,160
0,-1755,-907,175,0,150,2,140
0,-1753,-907,175,0,56,2,10
0,-1743,-907,31,0,56,4,90
0,-1744,-907,0,0,56,4,90
