1778967200897
2
0,-2819,-127,0,0,33,5,450
0,-2827,-127,-175,0,33,3,60
1778967201419
5
0,-2832,-128,-175,0,33,3,30
0,-2853,-193,-174,-426,0,7,120
0,-2887,-238,-156,-6,0,6,210
0,-2911,-217,-157,294,0,6,150
1778967201925
6
0,-2915,-207,-156,354,0,6,30
0,-2918,-199,-78,0,0,6,21
0,-2920,-199,-30,0,249,4,39
0,-2920,-200,0,0,249,4,90
0,-2921,-311,0,-6,0,6,330
1778967202427
6
0,-2921,-289,0,294,0,6,150
0,-2921,-279,-6,354,0,7,30
0,-2921,-271,-4,0,0,7,22
0,-2955,-272,-175,0,212,3,218
0,-2971,-324,-175,-486,0,7,90
1778967202937
4
0,-3013,-383,-175,-6,0,7,240
0,-3049,-340,-174,414,0,7,210
0,-3060,-340,0,0,0,7,0
0,-3060,-346,0,0,-7,17,60
1778967203448
1
0,-3060,-397,0,0,-7,17,510
1778967203971
4
0,-3060,-415,0,0,-7,17,180
0,-3094,-442,-227,-33,0,7,180
0,-3128,-425,-227,267,0,7,150
1778967204483
3
0,-3141,-405,-227,387,0,7,60
0,-3150,-405,0,0,0,7,0
0,-3150,-447,0,0,-6,17,450
1778967205994
1
0,-3150,-459,0,0,-6,17,510
1778967207529
1
0,-3150,-483,0,0,-6,17,510
1778967208052
1
0,-3150,-534,0,0,-6,17,510
1778967208544
1
0,-3150,-585,0,0,-6,17,510
1778967209072
1
0,-3150,-615,0,0,-6,17,510
1778967209571
4
0,-3150,-621,0,0,-6,17,60
0,-3115,-648,227,-33,0,6,180
0,-3054,-584,228,507,0,6,270
1778967210075
5
0,-3033,-530,228,670,0,6,90
0,-3027,-512,114,0,0,6,27
0,-3006,-512,175,0,210,2,123
0,-2997,-512,31,0,210,10,90
0,-2997,-512,0,0,210,10,180
1778967212644
5
0,-2997,-512,0,0,210,10,120
0,-2997,-512,0,0,210,4,60
0,-3010,-512,-175,0,210,3,90
0,-3019,-512,-31,0,210,5,90
0,-3020,-512,0,0,210,5,150
1778967213140
6
0,-3020,-512,0,0,210,5,90
0,-3017,-513,175,0,210,2,30
0,-3006,-549,175,-546,0,6,60
0,-2964,-623,150,-6,0,7,270
0,-2956,-621,151,114,0,7,60
1778967213649
1
0,-2902,-357,55,670,0,7,510
1778967214174
6
0,-2896,-276,31,670,0,7,120
0,-2896,-271,0,0,0,7,8
0,-2896,-271,0,0,212,3,22
0,-2914,-272,-175,0,212,3,120
0,-2956,-374,-175,-186,0,7,240
1778967214680
6
0,-2971,-382,-175,-6,0,7,90
0,-3024,-294,-175,594,0,7,300
0,-3052,-247,-239,514,0,7,120
0,-3060,-247,0,0,0,7,0
0,-3060,-247,0,0,-7,17,0
1778967215178
1
0,-3060,-298,0,0,-7,17,510
1778967215695
1
0,-3060,-349,0,0,-7,17,510
1778967216205
1
0,-3060,-400,0,0,-7,17,510
1778967216724
4
0,-3060,-415,0,0,-7,17,150
0,-3094,-442,-227,-33,0,7,180
0,-3135,-416,-227,327,0,7,180
1778967217215
3
0,-3141,-405,-227,387,0,7,30
0,-3150,-405,0,0,0,7,0
0,-3150,-453,0,0,-6,17,480
1778967217743
1
0,-3150,-504,0,0,-6,17,510
1778967218252
1
0,-3150,-555,0,0,-6,17,510
1778967218756
1
0,-3150,-606,0,0,-6,17,510
1778967219274
1
0,-3150,-647,0,0,-6,17,510
1778967221820
1
0,-3150,-638,0,0,-6,17,510
1778967222315
1
0,-3150,-647,0,0,-6,17,510
1778967222842
4
0,-3150,-647,0,0,-6,17,90
0,-3115,-674,227,-33,0,6,180
0,-3061,-625,228,447,0,6,240
1778967223345
5
0,-3019,-517,228,670,0,6,180
0,-3018,-512,114,0,0,6,7
0,-3005,-512,175,0,210,2,83
0,-2996,-512,31,0,210,4,90
0,-2996,-512,0,0,210,4,150
1778967223856
6
0,-2996,-513,0,0,210,4,120
0,-2996,-623,0,-6,0,6,330
0,-2996,-623,0,54,0,6,30
0,-2987,-623,0,0,0,6,0
0,-2987,-626,0,0,-5,16,30
1778967224874
1
0,-2987,-662,0,0,-5,16,510
1778967225392
1
0,-2987,-713,0,0,-5,16,510
1778967225893
1
0,-2987,-764,0,0,-5,16,510
1778967226412
5
0,-2987,-776,0,0,-5,16,120
0,-3021,-803,-227,-33,0,7,180
0,-3041,-798,-227,147,0,7,90
0,-3067,-766,-203,387,0,6,120
1778967226906
9
0,-3073,-753,-202,447,0,6,30
0,-3073,-751,-101,0,0,6,4
0,-3077,-751,-53,0,211,4,56
0,-3086,-752,-175,0,211,3,60
0,-3144,-862,-174,-6,0,7,330
0,-3149,-862,-174,54,0,7,30
0,-3135,-862,0,0,0,7,0
0,-3135,-862,0,0,-4,17,0
1778967227416
5
0,-3135,-910,0,0,-4,17,420
0,-3135,-910,0,0,0,7,30
0,-3135,-909,0,60,0,7,30
0,-3135,-907,0,0,0,7,20
0,-3135,-907,0,0,84,5,10
1778967227931
5
0,-3135,-907,0,0,84,5,150
0,-3105,-907,175,0,84,2,186
0,-3095,-907,175,0,45,2,54
0,-3086,-907,31,0,45,4,90
0,-3086,-907,0,0,45,4,30
