1777352115679
4
0,-109,-321,0,0,207,5,420
0,-116,-320,-177,27,207,3,60
0,-120,-320,-178,-11,207,3,17
0,-122,-320,-179,-11,206,3,13
1777352116168
4
0,-163,-322,-174,-11,206,3,240
0,-167,-323,-173,20,206,3,17
0,-193,-320,-176,20,205,3,147
0,-212,-310,-176,200,0,7,106
1777352116679
3
0,-270,-144,-176,670,0,7,330
0,-274,-127,-88,0,0,7,25
0,-299,-127,-175,0,5,3,155
1777352117190
4
0,-315,-127,-175,0,5,3,91
0,-335,-127,-175,0,1,3,119
0,-345,-127,-31,0,1,5,90
0,-346,-127,0,0,1,5,210
