1777352061096
3
0,45,-127,-175,0,24,3,72
0,5,-127,-175,0,23,3,228
0,-32,-127,-175,0,4,3,210
1777352061601
2
0,-45,-127,-175,0,4,3,74
0,-121,-127,-175,0,3,3,436
1777352062109
2
0,-135,-127,-175,0,3,3,79
0,-210,-127,-175,0,2,3,431
1777352062621
2
0,-225,-127,-175,0,2,3,85
0,-299,-127,-175,0,5,3,425
1777352063129
2
0,-315,-127,-175,0,5,3,91
0,-388,-127,-175,0,1,3,419
1777352063647
2
0,-405,-127,-175,0,1,3,97
0,-477,-127,-175,0,7,3,413
1777352064147
2
0,-495,-127,-175,0,7,3,102
0,-566,-127,-175,0,8,3,408
1777352064659
2
0,-585,-127,-175,0,8,3,108
0,-655,-127,-175,0,9,3,402
1777352065171
2
0,-675,-127,-175,0,9,3,114
0,-744,-127,-175,0,10,3,396
1777352065676
2
0,-765,-127,-175,0,10,3,119
0,-833,-127,-175,0,11,3,391
1777352066195
2
0,-855,-127,-175,0,11,3,125
0,-922,-127,-175,0,6,3,385
1777352066728
2
0,-945,-127,-175,0,6,3,131
0,-1011,-127,-175,0,13,3,379
1777352067207
2
0,-1035,-127,-175,0,13,3,137
0,-1100,-127,-175,0,14,3,373
1777352067720
2
0,-1125,-127,-175,0,14,3,142
0,-1189,-127,-175,0,15,3,368
1777352068230
2
0,-1215,-127,-175,0,15,3,148
0,-1278,-127,-175,0,16,3,362
1777352068741
2
0,-1305,-127,-175,0,16,3,154
0,-1367,-127,-175,0,17,3,356
1777352069248
2
0,-1395,-127,-175,0,17,3,159
0,-1456,-127,-175,0,12,3,351
1777352069763
2
0,-1485,-127,-175,0,12,3,165
0,-1545,-127,-175,0,18,3,345
1777352070274
2
0,-1575,-127,-175,0,18,3,171
0,-1634,-127,-175,0,20,3,339
1777352070777
2
0,-1665,-127,-175,0,20,3,177
0,-1723,-127,-175,0,21,3,333
1777352071296
2
0,-1755,-127,-175,0,21,3,182
0,-1812,-127,-175,0,19,3,328
1777352071799
2
0,-1845,-127,-175,0,19,3,188
0,-1901,-127,-175,0,38,3,322
1777352072317
2
0,-1935,-127,-175,0,38,3,194
0,-1990,-127,-175,0,27,3,316
1777352072830
2
0,-2025,-127,-175,0,27,3,199
0,-2079,-127,-175,0,29,3,311
1777352073331
2
0,-2115,-127,-175,0,29,3,205
0,-2168,-127,-175,0,31,3,305
1777352073842
2
0,-2205,-127,-175,0,31,3,211
0,-2257,-127,-175,0,28,3,299
1777352074352
2
0,-2295,-127,-175,0,28,3,217
0,-2346,-127,-175,0,34,3,293
1777352074858
2
0,-2385,-127,-175,0,34,3,222
0,-2435,-127,-175,0,32,3,288
1777352075376
2
0,-2475,-127,-175,0,32,3,228
0,-2524,-127,-175,0,37,3,282
1777352075877
2
0,-2565,-127,-175,0,37,3,234
0,-2613,-127,-175,0,36,3,276
1777352076387
2
0,-2655,-127,-175,0,36,3,239
0,-2702,-127,-175,0,35,3,271
1777352076901
2
0,-2745,-127,-175,0,35,3,245
0,-2791,-127,-175,0,33,3,265
1777352077414
2
0,-2835,-127,-175,0,33,3,251
0,-2880,-127,-175,0,30,3,259
1777352077919
2
0,-2925,-127,-175,0,30,3,257
0,-2969,-127,-175,0,26,3,253
1777352078431
2
0,-3015,-127,-175,0,26,3,262
0,-3058,-127,-175,0,39,3,248
1777352078951
2
0,-3105,-127,-175,0,39,3,268
0,-3147,-127,-175,0,43,3,242
1777352079453
5
0,-3155,-127,-175,0,43,3,45
0,-3195,-127,-175,0,40,3,228
0,-3204,-127,-175,0,42,3,57
0,-3205,-127,0,0,42,3,150
0,-3205,-127,0,0,42,5,30
1777352080978
3
0,-3195,-127,175,0,42,2,72
0,-3155,-127,175,0,40,2,228
0,-3118,-127,175,0,43,2,210
1777352081489
2
0,-3105,-127,175,0,43,2,74
0,-3029,-127,175,0,39,2,436
1777352081987
2
0,-3015,-127,175,0,39,2,80
0,-2940,-127,175,0,26,2,430
1777352082510
2
0,-2925,-127,175,0,26,2,85
0,-2851,-127,175,0,30,2,425
1777352083021
2
0,-2835,-127,175,0,30,2,91
0,-2762,-127,175,0,33,2,419
1777352083529
2
0,-2745,-127,175,0,33,2,97
0,-2673,-127,175,0,35,2,413
1777352084040
2
0,-2655,-127,175,0,35,2,102
0,-2584,-127,175,0,36,2,408
1777352084550
2
0,-2565,-127,175,0,36,2,108
0,-2495,-127,175,0,37,2,402
1777352085058
2
0,-2475,-127,175,0,37,2,114
0,-2406,-127,175,0,32,2,396
1777352085567
2
0,-2385,-127,175,0,32,2,120
0,-2317,-127,175,0,34,2,390
1777352086087
2
0,-2295,-127,175,0,34,2,125
0,-2228,-127,175,0,28,2,385
1777352086591
2
0,-2205,-127,175,0,28,2,131
0,-2139,-127,175,0,31,2,379
1777352087110
2
0,-2115,-127,175,0,31,2,137
0,-2050,-127,175,0,29,2,373
1777352087616
2
0,-2025,-127,175,0,29,2,142
0,-1961,-127,175,0,27,2,368
1777352088121
2
0,-1935,-127,175,0,27,2,148
0,-1872,-127,175,0,38,2,362
1777352088629
2
0,-1845,-127,175,0,38,2,154
0,-1783,-127,175,0,19,2,356
1777352089142
2
0,-1755,-127,175,0,19,2,160
0,-1694,-127,175,0,21,2,350
1777352089653
2
0,-1665,-127,175,0,21,2,165
0,-1605,-127,175,0,20,2,345
1777352090158
2
0,-1575,-127,175,0,20,2,171
0,-1516,-127,175,0,18,2,339
1777352090673
2
0,-1485,-127,175,0,18,2,177
0,-1427,-127,175,0,12,2,333
1777352091182
2
0,-1395,-127,175,0,12,2,182
0,-1338,-127,175,0,17,2,328
1777352091686
2
0,-1305,-127,175,0,17,2,188
0,-1249,-127,175,0,16,2,322
1777352092198
2
0,-1215,-127,175,0,16,2,194
0,-1160,-127,175,0,15,2,316
1777352092710
2
0,-1125,-127,175,0,15,2,200
0,-1071,-127,175,0,14,2,310
1777352093225
2
0,-1035,-127,175,0,14,2,205
0,-982,-127,175,0,13,2,305
1777352093729
2
0,-945,-127,175,0,13,2,211
0,-893,-127,175,0,6,2,299
1777352094238
2
0,-855,-127,175,0,6,2,217
0,-804,-127,175,0,11,2,293
1777352094756
2
0,-765,-127,175,0,11,2,222
0,-715,-127,175,0,10,2,288
1777352095266
2
0,-675,-127,175,0,10,2,228
0,-626,-127,175,0,9,2,282
1777352095770
2
0,-585,-127,175,0,9,2,234
0,-537,-127,175,0,8,2,276
1777352096279
2
0,-495,-127,175,0,8,2,240
0,-448,-127,175,0,7,2,270
1777352096819
2
0,-405,-127,175,0,7,2,245
0,-359,-127,175,0,1,2,265
1777352097300
2
0,-315,-127,175,0,1,2,251
0,-270,-127,175,0,5,2,259
1777352097816
2
0,-225,-127,175,0,5,2,257
0,-181,-127,175,0,2,2,253
1777352098327
2
0,-135,-127,175,0,2,2,262
0,-92,-127,175,0,3,2,248
1777352098827
2
0,-45,-127,175,0,3,2,268
0,-3,-127,175,0,4,2,242
1777352099339
4
0,5,-127,175,0,4,2,45
0,45,-127,175,0,23,2,228
0,54,-127,175,0,24,2,57
0,55,-127,0,0,24,4,180
