1778965176194
3
0,-265,-907,0,0,52,4,180
0,-315,-907,-175,0,52,3,300
0,-320,-907,-175,0,58,3,30
1778965176721
2
0,-405,-907,-175,0,58,3,485
0,-409,-907,-175,0,153,3,25
1778965177230
2
0,-451,-907,-175,0,153,3,240
0,-455,-907,0,0,153,3,270
1778965177742
2
0,-455,-907,0,0,153,3,60
0,-455,-907,0,0,153,5,450
1778965178255
3
0,-455,-907,0,0,153,5,120
0,-405,-907,175,0,153,2,300
0,-389,-907,175,0,58,2,90
1778965178767
2
0,-315,-907,175,0,58,2,422
0,-300,-907,175,0,52,2,88
1778965179273
3
0,-268,-907,175,0,52,2,180
0,-265,-907,0,0,52,2,270
0,-265,-907,0,0,52,4,60
