1778966452232
2
0,-715,-907,0,0,46,4,450
0,-723,-907,-175,0,46,3,60
1778966452743
2
0,-765,-907,-175,0,46,3,239
0,-812,-907,-175,0,59,3,271
1778966453253
2
0,-855,-907,-175,0,59,3,245
0,-901,-907,-175,0,86,3,265
1778966453746
2
0,-905,-907,0,0,86,3,420
0,-905,-907,0,0,86,5,90
1778966454785
3
0,-905,-907,0,0,86,5,180
0,-855,-907,175,0,86,2,300
0,-850,-907,175,0,59,2,30
1778966455295
2
0,-765,-907,175,0,59,2,485
0,-761,-907,175,0,46,2,25
1778966455803
2
0,-719,-907,175,0,46,2,240
0,-715,-907,0,0,46,2,270
1778966456298
2
0,-715,-907,0,0,46,2,90
0,-715,-907,0,0,46,4,420
