1778966942335
2
0,-1165,-907,0,0,48,4,240
0,-1210,-907,-175,0,48,3,270
1778966942853
2
0,-1215,-907,-175,0,48,3,28
0,-1299,-907,-175,0,44,3,482
1778966943344
3
0,-1305,-907,-175,0,44,3,34
0,-1351,-907,-175,0,184,3,266
0,-1355,-907,0,0,184,3,210
1778966943857
2
0,-1355,-907,0,0,184,3,180
0,-1355,-907,0,0,184,5,330
1778966944380
3
0,-1355,-907,0,0,184,5,90
0,-1305,-907,175,0,184,2,300
0,-1284,-907,175,0,44,2,120
1778966944880
2
0,-1215,-907,175,0,44,2,394
0,-1195,-907,175,0,48,2,116
1778966945392
3
0,-1168,-907,175,0,48,2,150
0,-1165,-907,0,0,48,2,210
0,-1165,-907,0,0,48,4,150
