1778967008643
3
0,-1805,-907,0,0,150,5,90
0,-1755,-907,175,0,150,2,300
0,-1734,-907,175,0,56,2,120
1778967009152
2
0,-1665,-907,175,0,56,2,394
0,-1645,-907,175,0,49,2,116
1778967009659
2
0,-1618,-907,175,0,49,2,150
0,-1615,-907,0,0,49,2,360
1778967010172
2
0,-1615,-907,0,0,49,2,60
0,-1615,-907,0,0,49,4,450
1778967010677
3
0,-1615,-907,0,0,49,4,60
0,-1665,-907,-175,0,49,3,300
0,-1691,-907,-175,0,56,3,150
1778967011182
2
0,-1755,-907,-175,0,56,3,365
0,-1780,-907,-175,0,150,3,145
1778967011703
3
0,-1801,-907,-175,0,150,3,120
0,-1805,-907,0,0,150,3,180
0,-1805,-907,0,0,150,5,210
