1778967119821
3
0,-2065,-907,0,0,51,4,150
0,-2115,-907,-175,0,51,3,300
0,-2125,-907,-175,0,57,3,60
1778967120336
2
0,-2205,-907,-175,0,57,3,457
0,-2214,-907,-175,0,135,3,53
1778967120825
2
0,-2250,-907,-175,0,135,3,210
0,-2255,-907,0,0,135,3,300
1778967121340
2
0,-2255,-907,0,0,135,3,30
0,-2255,-907,0,0,135,5,480
1778967121862
2
0,-2255,-907,0,0,135,5,210
0,-2205,-907,175,0,135,2,300
1778967122370
2
0,-2205,-907,175,0,135,2,0
0,-2116,-907,175,0,57,2,510
1778967122882
3
0,-2115,-907,175,0,57,2,5
0,-2068,-907,175,0,51,2,265
0,-2065,-907,0,0,51,2,240
1778967123393
2
0,-2065,-907,0,0,51,2,60
0,-2065,-907,0,0,51,4,450
