1778967173881
2
0,-2515,-907,0,0,54,4,450
0,-2523,-907,-175,0,54,3,60
1778967174392
2
0,-2565,-907,-175,0,54,3,239
0,-2612,-907,-175,0,55,3,271
1778967174887
2
0,-2655,-907,-175,0,55,3,245
0,-2701,-907,-175,0,108,3,265
1778967175414
2
0,-2705,-907,0,0,108,3,360
0,-2705,-907,0,0,108,5,150
1778967175912
2
0,-2705,-907,0,0,108,5,210
0,-2655,-907,175,0,108,2,300
1778967176430
2
0,-2655,-907,175,0,108,2,0
0,-2566,-907,175,0,55,2,510
1778967176945
3
0,-2565,-907,175,0,55,2,5
0,-2518,-907,175,0,54,2,265
0,-2515,-907,0,0,54,2,240
1778967177433
2
0,-2515,-907,0,0,54,2,90
0,-2515,-907,0,0,54,4,420
