1778967235593
3
0,-2965,-907,0,0,47,4,90
0,-3015,-907,-175,0,47,3,300
0,-3036,-907,-175,0,45,3,120
1778967236089
2
0,-3105,-907,-175,0,45,3,394
0,-3125,-907,-175,0,84,3,116
1778967236598
2
0,-3151,-907,-175,0,84,3,150
0,-3155,-907,0,0,84,3,360
1778967237110
2
0,-3155,-907,0,0,84,5,480
0,-3152,-907,175,0,84,2,30
1778967237631
2
0,-3105,-907,175,0,84,2,268
0,-3063,-907,175,0,45,2,242
1778967238140
2
0,-3015,-907,175,0,45,2,274
0,-2974,-907,175,0,47,2,236
1778967238640
3
0,-2968,-907,175,0,47,2,30
0,-2965,-907,0,0,47,2,390
0,-2965,-907,0,0,47,4,90
