1738560833985
4
0,-874,1159,0,0,632,5,210
0,-874,1082,0,-15,0,7,270
0,-874,1083,0,45,0,7,30
1738560834483
3
0,-874,1095,0,225,0,7,90
0,-884,1095,0,0,0,7,0
0,-884,1053,0,0,-7,17,420
1738560834999
1
0,-884,1002,0,0,-7,17,510
1738560835516
1
0,-884,951,0,0,-7,17,510
1738560836024
1
0,-884,900,0,0,-7,17,510
1738560836537
5
0,-884,875,0,0,-7,17,180
0,-884,875,0,0,0,7,30
0,-884,875,0,60,0,7,30
0,-884,878,0,0,0,7,20
0,-884,878,0,0,716,5,250
