1738560848762
3
0,-884,878,0,0,716,5,300
0,-884,880,0,0,716,11,30
0,-884,898,0,0,-7,17,180
1738560849286
1
0,-884,949,0,0,-7,17,510
1738560849797
1
0,-884,1000,0,0,-7,17,510
1738560850306
1
0,-884,1051,0,0,-7,17,510
1738560850816
1
0,-884,1102,0,0,-7,17,510
1738560851318
5
0,-884,1137,0,0,-7,17,330
0,-884,1137,0,0,0,7,30
0,-884,1151,0,240,0,7,120
0,-884,1160,0,0,0,7,30
0,-884,1160,0,0,632,11,0
1738560851835
2
0,-884,1160,0,0,632,11,330
0,-884,1160,0,0,632,5,180
