1779575994051
4
0,-384,154,0,0,340,5,240
0,-381,154,84,0,340,2,60
0,-377,154,12,0,340,4,90
0,-377,154,0,0,340,4,120
1779575994570
7
0,-377,154,0,0,340,4,300
0,-377,154,0,0,340,4,30
0,43,-148,0,180,0,6,90
0,43,-146,0,0,0,6,15
0,43,-146,0,0,203,4,75
