1777156180029
4
0,-42,143,0,0,13,5,180
0,-49,143,-175,0,13,3,60
0,-59,143,-31,0,13,5,90
0,-60,143,0,0,13,5,180
1777156180527
7
0,-60,142,0,0,13,5,120
0,-60,76,0,-426,0,7,120
0,-58,31,8,-6,0,6,210
0,-58,31,8,54,0,6,30
0,-58,31,0,0,0,6,0
0,-58,29,0,0,-1,16,30
1777156181048
1
0,-58,-22,0,0,-1,16,510
1777156181543
1
0,-58,-73,0,0,-1,16,510
1777156182058
1
0,-58,-124,0,0,-1,16,510
1777156182565
1
0,-58,-175,0,0,-1,16,510
1777156183087
1
0,-58,-226,0,0,-1,16,510
1777156183599
1
0,-58,-277,0,0,-1,16,510
1777156184102
1
0,-58,-328,0,0,-1,16,510
1777156184615
3
0,-58,-373,0,0,-1,16,480
0,-58,-373,228,-333,0,6,30
1777156185129
2
0,-23,-400,228,-33,0,6,150
0,58,-283,228,670,0,6,360
1777156185620
5
0,71,-242,228,670,0,6,60
0,73,-238,101,-3,0,6,7
0,116,-239,174,-6,31,2,263
0,125,-240,30,-1,31,4,90
0,126,-240,0,0,31,4,90
