1777156161155
4
0,-32,143,0,0,13,5,180
0,-34,143,-175,0,13,3,30
0,-43,143,-31,0,13,5,90
0,-44,143,0,0,13,5,210
1777156161654
5
0,-44,142,0,0,13,5,120
0,-44,76,0,-426,0,7,120
0,-45,31,-8,-6,0,7,210
0,-46,34,-9,114,0,7,60
1777156162169
3
0,-47,86,-9,474,0,7,180
0,-58,86,0,0,0,7,0
0,-58,54,0,0,-1,17,330
1777156162684
1
0,-58,3,0,0,-1,17,510
1777156163198
1
0,-58,-48,0,0,-1,17,510
1777156163706
1
0,-58,-99,0,0,-1,17,510
1777156164215
1
0,-58,-150,0,0,-1,17,510
1777156164728
1
0,-58,-201,0,0,-1,17,510
1777156165237
1
0,-58,-252,0,0,-1,17,510
1777156165745
1
0,-58,-303,0,0,-1,17,510
1777156166260
3
0,-58,-339,0,0,-1,17,450
0,-65,-348,-227,-273,0,7,60
1777156166768
5
0,-92,-366,-227,-33,0,7,120
0,-167,-268,-226,627,0,7,330
0,-167,-266,-62,-9,0,7,1
0,-168,-267,-61,-16,80,3,15
0,-171,-268,-169,-45,79,3,44
1777156167271
5
0,-191,-273,-168,-45,79,3,120
0,-194,-274,-173,19,79,3,16
0,-221,-271,-170,47,78,3,153
0,-250,-263,-186,12,77,3,161
0,-261,-262,-175,12,76,3,60
1777156167769
6
0,-279,-261,-175,12,76,3,102
0,-318,-214,-175,432,0,7,228
0,-323,-201,-73,-4,0,7,26
0,-327,-201,-174,-9,73,3,34
0,-332,-202,-174,16,73,3,28
0,-348,-200,-176,17,72,3,92
1777156168283
3
0,-363,-198,-175,17,72,3,90
0,-373,-198,-32,3,72,5,90
0,-374,-198,0,0,72,5,330
