1777156463074
3
0,916,-184,-178,31,91,3,121
0,853,-173,-177,30,90,3,354
0,847,-171,-177,91,0,7,35
1777156463588
1
0,757,87,-177,670,0,7,510
1777156464095
6
0,746,127,-177,670,0,7,60
0,742,143,-88,0,0,7,24
0,720,143,-175,0,9,3,136
0,706,143,-175,0,3,3,80
0,696,143,-31,0,3,5,90
0,696,143,0,0,3,5,120
