1777156486529
2
0,552,-247,0,0,36,4,450
0,560,-248,175,-7,36,2,60
1777156487041
4
0,581,-249,171,-35,36,2,120
0,629,-259,171,-35,37,2,280
0,632,-259,171,-35,0,6,20
0,648,-255,171,144,0,6,90
1777156487544
1
0,732,17,144,670,0,6,510
1777156488066
6
0,740,57,138,670,0,6,60
0,755,137,114,670,0,7,120
0,756,143,0,0,0,7,7
0,756,143,0,0,9,3,23
0,720,143,-175,0,9,3,220
0,706,143,-175,0,3,3,80
1777156488561
3
0,685,143,-175,0,3,3,120
0,675,143,-31,0,3,5,90
0,675,143,0,0,3,5,300
