1777156447263
2
0,124,-240,0,0,31,5,270
0,85,-239,-175,6,31,3,240
1777156447775
2
0,38,-237,-175,6,31,3,268
0,-4,-178,-175,486,0,7,242
1777156448287
3
0,-81,135,-153,670,0,7,480
0,-84,143,-76,0,0,7,12
0,-85,143,-77,0,13,3,18
1777156448787
4
0,-90,143,-175,0,13,3,36
0,-94,143,-175,0,14,3,24
0,-103,143,-31,0,14,5,90
0,-104,143,0,0,14,5,360
