1777156503870
3
0,372,-232,0,0,34,5,300
0,353,-232,-175,1,34,3,120
0,344,-232,-31,0,34,11,90
1777156504388
7
0,343,-232,0,0,34,11,90
1777156504882
7
0,345,99,0,0,44,4,3
0,328,99,-175,0,44,3,112
0,326,99,-175,0,0,7,8
0,321,100,-175,60,0,7,30
1777156505394
4
0,294,131,-175,360,0,7,150
0,290,143,-87,0,0,7,30
0,270,143,-175,0,5,3,121
0,233,143,-175,0,6,3,209
1777156505913
3
0,212,143,-175,0,6,3,120
0,202,143,-31,0,6,5,90
0,202,143,0,0,6,5,300
