1777156435538
3
0,-193,-273,0,0,79,4,240
0,-168,-267,184,28,79,2,153
0,-147,-264,177,28,80,2,117
1777156436041
3
0,-136,-262,178,7,80,2,62
0,-91,-260,175,7,81,2,255
0,-57,-226,175,368,0,6,193
1777156436560
1
0,32,93,175,670,0,6,510
1777156437053
6
0,42,133,175,670,0,6,60
0,45,143,87,0,0,6,15
0,90,143,175,0,7,2,272
0,92,143,175,0,12,2,13
0,101,143,31,0,12,4,90
0,102,143,0,0,12,4,60
