1777157939612
4
0,-629,-209,0,0,67,5,180
0,-636,-210,-172,-28,67,3,60
0,-645,-211,-30,-4,67,5,90
0,-646,-212,0,0,67,5,180
1777157940124
7
0,-646,-213,0,0,67,5,150
0,-646,-264,0,-486,0,7,90
0,-644,-323,8,-6,0,6,240
0,-643,-323,8,54,0,6,30
0,-638,-323,0,0,0,6,0
0,-638,-323,0,0,-2,16,0
1777157940618
1
0,-638,-374,0,0,-2,16,510
1777157941144
1
0,-638,-425,0,0,-2,16,510
1777157941658
1
0,-638,-476,0,0,-2,16,510
1777157942160
1
0,-638,-527,0,0,-2,16,510
1777157942674
1
0,-638,-578,0,0,-2,16,510
1777157943176
1
0,-638,-629,0,0,-2,16,510
1777157943692
1
0,-638,-680,0,0,-2,16,510
1777157944198
1
0,-638,-731,0,0,-2,16,510
1777157944705
1
0,-638,-782,0,0,-2,16,510
1777157945227
1
0,-638,-797,0,0,-2,16,510
1777157945731
4
0,-638,-809,0,0,-2,16,120
0,-603,-836,227,-33,0,6,180
0,-556,-799,228,387,0,6,210
1777157946244
5
0,-528,-738,228,627,0,6,120
0,-519,-738,0,0,0,6,0
0,-519,-765,0,0,-3,16,270
0,-499,-787,228,-153,0,6,120
1777157946740
2
0,-485,-792,228,-33,0,6,60
0,-383,-615,216,670,0,6,450
1777157947259
6
0,-351,-514,204,670,0,6,150
0,-349,-505,89,-3,0,6,12
0,-334,-506,173,-23,97,2,101
0,-322,-507,173,-23,98,2,67
0,-313,-508,30,-4,98,4,90
0,-313,-509,0,0,98,4,90
