1777161873697
3
0,-637,-210,0,0,67,5,360
0,-644,-211,-172,-28,67,3,60
0,-654,-213,-31,-5,67,5,90
1777161874210
6
0,-654,-213,0,0,67,5,90
0,-651,-212,177,28,67,2,30
0,-642,-211,35,5,67,4,90
0,-641,-213,0,0,67,4,240
0,-642,-249,0,-546,0,6,60
1777161874708
4
0,-642,-323,0,-6,0,6,270
0,-642,-322,0,54,0,6,30
0,-638,-322,0,0,0,6,0
0,-638,-344,0,0,-2,16,210
1777161875228
1
0,-638,-395,0,0,-2,16,510
1777161875726
1
0,-638,-446,0,0,-2,16,510
1777161876248
1
0,-638,-497,0,0,-2,16,510
1777161876761
1
0,-638,-548,0,0,-2,16,510
1777161877263
1
0,-638,-599,0,0,-2,16,510
1777161877780
1
0,-638,-650,0,0,-2,16,510
1777161878290
1
0,-638,-701,0,0,-2,16,510
1777161878801
1
0,-638,-752,0,0,-2,16,510
1777161879310
1
0,-638,-803,0,0,-2,16,510
1777161879819
4
0,-638,-833,0,0,-2,16,300
0,-603,-860,227,-33,0,6,180
0,-597,-861,228,27,0,6,30
1777161880329
3
0,-528,-762,228,627,0,6,300
0,-519,-762,0,0,0,6,0
0,-519,-784,0,0,-3,16,210
1777161880840
1
0,-519,-835,0,0,-3,16,510
1777161881342
1
0,-519,-886,0,0,-3,16,510
1777161881855
4
0,-519,-898,0,0,-3,16,150
0,-484,-925,227,-33,0,6,180
0,-444,-899,227,327,0,6,180
1777161882370
3
0,-409,-827,226,627,0,6,150
0,-403,-827,0,0,0,6,0
0,-403,-863,0,0,-5,16,360
1777161882875
1
0,-403,-914,0,0,-5,16,510
1777161883393
3
0,-403,-920,0,0,-5,16,390
0,-383,-942,228,-153,0,6,120
1777161883877
4
0,-369,-947,227,-33,0,6,60
0,-295,-852,165,30,0,6,325
0,-285,-850,23,4,122,4,95
0,-285,-851,0,0,122,4,30
