1777158039064
9
0,414,-378,0,0,41,5,180
0,398,-382,-172,-28,41,3,108
0,390,-383,-172,-28,40,3,42
0,381,-384,-30,-4,40,11,90
0,381,-384,0,0,40,11,30
1777158039560
5
0,380,-232,-2,0,34,5,1
0,381,-233,0,0,34,5,60
1777158040076
3
0,362,-232,-175,1,34,3,120
0,353,-232,-31,0,34,5,90
0,353,-232,0,0,34,5,300
