1777158064566
3
0,54,-512,0,0,102,4,150
0,99,-514,171,-35,102,2,272
0,114,-517,171,-36,103,2,88
1777158065076
6
0,124,-519,171,-35,103,2,60
0,133,-521,30,-6,103,4,90
0,133,-521,0,0,103,4,90
0,147,-524,171,-35,103,2,92
0,151,-524,171,-35,0,6,28
0,177,-508,171,264,0,6,150
1777158065573
2
0,256,-236,118,12,0,6,466
0,262,-236,176,18,33,2,44
1777158066095
3
0,277,-234,175,18,33,2,90
0,287,-233,32,3,33,4,90
0,288,-234,0,0,33,4,330
