1777158051813
3
0,-368,-504,0,0,97,5,30
0,-444,-502,-175,6,97,3,448
0,-450,-501,-175,66,0,7,32
1777158052327
2
0,-512,-351,-168,670,0,7,360
0,-536,-251,-139,670,0,6,150
1777158052836
9
0,-543,-210,-127,670,0,6,60
0,-546,-198,0,0,0,6,19
0,-546,-198,0,0,69,2,11
0,-538,-198,175,0,69,2,60
0,-537,-198,171,-34,69,2,6
0,-507,-203,171,-34,70,2,174
0,-502,-205,172,26,70,2,29
0,-480,-201,177,27,71,2,121
0,-476,-201,130,20,71,4,30
1777158053339
2
0,-471,-200,35,5,71,4,60
0,-471,-200,0,0,71,4,450
