1777161935915
9
0,-125,-849,0,0,116,4,30
0,-132,-851,-172,-26,116,3,60
0,-141,-852,-30,-4,116,5,90
0,-142,-852,0,0,116,5,90
0,-142,-852,0,0,116,11,150
1777161936419
1
1777161936940
6
0,-142,-497,-2,0,100,3,28
0,-155,-497,-175,1,100,3,90
0,-164,-497,-31,0,100,5,90
0,-165,-497,0,0,100,5,90
