1777162047603
4
0,77,-857,0,0,119,4,60
0,119,-870,174,-16,119,2,264
0,151,-873,174,-16,120,2,183
0,152,-873,174,-16,0,6,3
1777162048105
4
0,225,-707,107,6,0,6,422
0,232,-707,175,11,109,2,58
0,234,-707,173,-27,109,2,9
0,238,-708,174,-27,110,2,21
1777162048612
3
0,263,-711,172,-26,110,2,150
0,273,-713,30,-4,110,4,90
0,274,-713,0,0,110,4,270
