1777162263340
5
0,212,-708,0,0,109,5,120
0,188,-709,-174,-11,109,3,150
0,187,-710,-173,20,109,3,8
0,161,-707,-176,20,108,3,148
0,146,-702,-176,140,0,7,84
1777162263833
2
0,77,-513,-101,4,0,7,386
0,57,-512,-175,7,102,3,124
1777162264353
3
0,25,-510,-175,7,102,3,180
0,16,-510,-31,1,102,5,90
0,16,-511,0,0,102,5,240
