1777162460191
4
0,684,-759,0,0,157,4,360
0,702,-760,174,-13,157,2,120
0,703,-761,174,13,157,2,3
0,708,-761,174,13,158,2,27
1777162460708
2
0,729,-759,175,13,158,2,119
0,798,-605,176,670,0,6,391
1777162461205
6
0,817,-532,136,21,0,6,109
0,828,-530,177,27,133,2,71
0,831,-530,178,-17,133,2,13
0,839,-530,174,-16,134,2,47
0,848,-531,30,-2,134,4,90
0,849,-532,0,0,134,4,180
