1777163033952
2
0,722,-535,0,0,132,5,480
0,719,-535,-178,36,132,3,30
1777163034461
2
0,684,-528,-178,35,132,3,196
0,628,-427,-178,636,0,7,314
1777163034969
2
0,580,-248,-102,4,0,7,267
0,539,-247,-175,7,36,3,243
1777163035464
2
0,485,-245,-170,40,36,3,308
0,449,-236,-179,43,35,3,202
1777163035977
5
0,438,-233,-179,43,35,3,60
0,435,-233,-151,1,35,5,20
0,433,-232,-151,1,34,5,10
0,426,-232,-7,0,34,5,90
0,426,-233,0,0,34,5,330
