1777162518327
2
0,1038,-879,0,0,144,5,420
0,1025,-882,-173,-28,144,3,90
1777162518851
3
0,1022,-882,-172,32,144,3,17
0,990,-876,-178,31,143,3,180
0,934,-866,-177,31,142,3,313
1777162519359
2
0,927,-865,-177,30,142,3,39
0,843,-665,-177,670,0,7,471
1777162519870
3
0,811,-544,-177,670,0,7,180
0,808,-533,-35,-5,0,7,15
0,758,-541,-173,-27,133,3,315
1777162520366
4
0,754,-542,-171,34,133,3,23
0,747,-540,-178,35,132,3,37
0,737,-538,-36,7,132,5,90
0,737,-539,0,0,132,5,360
