1777162504053
5
0,1122,-865,0,0,146,5,300
0,1114,-865,-175,0,146,3,60
0,1110,-865,-171,-36,146,3,23
0,1098,-867,-171,-36,145,3,67
0,1091,-869,-77,-17,145,11,60
1777162504567
7
0,1089,-869,-30,-6,145,11,30
0,1088,-869,0,0,145,11,30
1777162505061
4
0,1124,-617,175,18,127,2,219
0,1134,-617,33,3,127,4,90
1777162505582
1
0,1134,-617,0,0,127,4,510
