1777162653996
2
0,1457,-307,0,0,106,5,390
0,1439,-308,-175,4,106,3,120
1777162654509
4
0,1417,-307,-163,63,106,3,125
0,1394,-298,-197,19,105,3,129
0,1363,-295,-175,17,104,3,172
0,1348,-290,-176,137,0,7,84
1777162655004
3
0,1300,-180,-176,670,0,7,270
0,1298,-175,-34,-5,0,7,6
0,1263,-181,-173,-27,82,3,234
1777162655525
5
0,1242,-184,-172,-26,82,3,120
0,1238,-185,-171,35,82,3,24
0,1231,-183,-178,36,89,3,36
0,1222,-181,-37,7,89,5,90
0,1221,-182,0,0,89,5,240
