1777155715419
2
0,1543,143,0,0,23,5,240
0,1498,143,-175,0,23,3,270
1777155715913
3
0,1490,143,-175,0,23,3,45
0,1440,143,-175,0,25,3,285
0,1409,143,-175,0,26,3,180
1777155716436
2
0,1350,143,-175,0,26,3,337
0,1320,143,-175,0,30,3,173
1777155716941
2
0,1260,143,-175,0,30,3,342
0,1231,143,-175,0,28,3,168
1777155717444
2
0,1170,143,-175,0,28,3,348
0,1142,143,-175,0,22,3,162
1777155717967
2
0,1080,143,-175,0,22,3,354
0,1053,143,-175,0,27,3,156
1777155718464
2
0,990,143,-175,0,27,3,359
0,964,143,-175,0,29,3,151
1777155718987
2
0,900,143,-175,0,29,3,365
0,875,143,-175,0,21,3,145
1777155719478
2
0,810,143,-175,0,21,3,371
0,786,143,-175,0,9,3,139
1777155720009
2
0,720,143,-175,0,9,3,377
0,697,143,-175,0,3,3,133
1777155720501
2
0,630,143,-175,0,3,3,382
0,608,143,-175,0,4,3,128
1777155721027
2
0,540,143,-175,0,4,3,388
0,519,143,-175,0,1,3,122
1777155721541
2
0,450,143,-175,0,1,3,394
0,430,143,-175,0,2,3,116
1777155722031
2
0,360,143,-175,0,2,3,399
0,341,143,-175,0,5,3,111
1777155722556
2
0,270,143,-175,0,5,3,405
0,252,143,-175,0,6,3,105
1777155723060
2
0,180,143,-175,0,6,3,411
0,163,143,-175,0,12,3,99
1777155723578
2
0,90,143,-175,0,12,3,417
0,74,143,-175,0,7,3,93
1777155724088
2
0,0,143,-175,0,7,3,422
0,-15,143,-175,0,13,3,88
1777155724586
2
0,-90,143,-175,0,13,3,428
0,-104,143,-175,0,14,3,82
1777155725093
2
0,-180,143,-175,0,14,3,434
0,-193,143,-175,0,15,3,76
1777155725599
2
0,-270,143,-175,0,15,3,439
0,-282,143,-175,0,17,3,71
1777155726127
2
0,-360,143,-175,0,17,3,445
0,-371,143,-175,0,18,3,65
1777155726625
2
0,-450,143,-175,0,18,3,451
0,-460,143,-175,0,19,3,59
1777155727146
2
0,-540,143,-175,0,19,3,457
0,-549,143,-175,0,20,3,53
1777155727681
2
0,-630,143,-175,0,20,3,462
0,-638,143,-175,0,8,3,48
1777155728151
2
0,-720,143,-175,0,8,3,468
0,-727,143,-175,0,16,3,42
1777155728679
2
0,-770,143,-175,0,16,3,245
0,-816,143,-175,0,11,3,265
1777155729183
3
0,-842,143,-175,0,11,3,150
0,-843,143,0,0,11,3,210
0,-843,143,0,0,11,5,150
1777155730195
2
0,-843,143,0,0,11,5,180
0,-788,143,175,0,11,2,330
1777155730707
3
0,-770,143,175,0,11,2,102
0,-720,143,175,0,16,2,285
0,-698,143,175,0,8,2,123
1777155731215
2
0,-630,143,175,0,8,2,388
0,-609,143,175,0,20,2,122
1777155731728
2
0,-540,143,175,0,20,2,394
0,-520,143,175,0,19,2,116
1777155732243
2
0,-450,143,175,0,19,2,400
0,-431,143,175,0,18,2,110
1777155732760
2
0,-360,143,175,0,18,2,405
0,-342,143,175,0,17,2,105
1777155733266
2
0,-270,143,175,0,17,2,411
0,-253,143,175,0,15,2,99
1777155733776
2
0,-180,143,175,0,15,2,417
0,-164,143,175,0,14,2,93
1777155734270
2
0,-90,143,175,0,14,2,422
0,-75,143,175,0,13,2,88
1777155734798
2
0,0,143,175,0,13,2,428
0,14,143,175,0,7,2,82
1777155735294
2
0,90,143,175,0,7,2,434
0,103,143,175,0,12,2,76
1777155735810
2
0,180,143,175,0,12,2,440
0,192,143,175,0,6,2,70
1777155736325
2
0,270,143,175,0,6,2,445
0,281,143,175,0,5,2,65
1777155736832
2
0,360,143,175,0,5,2,451
0,370,143,175,0,2,2,59
1777155737347
2
0,450,143,175,0,2,2,457
0,459,143,175,0,1,2,53
1777155737848
2
0,540,143,175,0,1,2,462
0,548,143,175,0,4,2,48
1777155738351
2
0,630,143,175,0,4,2,468
0,637,143,175,0,3,2,42
1777155738878
2
0,720,143,175,0,3,2,474
0,726,143,175,0,9,2,36
1777155739385
2
0,810,143,175,0,9,2,480
0,815,143,175,0,21,2,30
1777155739896
2
0,900,143,175,0,21,2,485
0,904,143,175,0,29,2,25
1777155740408
2
0,990,143,175,0,29,2,491
0,993,143,175,0,27,2,19
1777155740909
2
0,1080,143,175,0,27,2,497
0,1082,143,175,0,22,2,13
1777155741424
2
0,1170,143,175,0,22,2,502
0,1171,143,175,0,28,2,8
1777155741935
2
0,1260,143,175,0,28,2,508
0,1260,143,175,0,30,2,2
1777155742440
1
0,1349,143,175,0,30,2,510
1777155742938
2
0,1350,143,175,0,30,2,5
0,1438,143,175,0,26,2,505
1777155743465
3
0,1440,143,175,0,26,2,11
0,1490,143,175,0,25,2,285
0,1527,143,175,0,23,2,214
1777155743960
3
0,1542,143,175,0,23,2,90
0,1543,143,0,0,23,2,270
0,1543,143,0,0,23,4,150
