1777157278048
3
0,122,-518,0,0,103,5,360
0,99,-514,-182,7,103,3,143
0,98,-514,-182,8,102,3,7
1777157278564
1
0,9,-510,-175,7,102,3,510
1777157279073
3
0,3,-510,-170,40,102,3,34
0,-47,-498,-184,1,101,3,280
0,-82,-498,-175,1,100,3,196
1777157279575
1
0,-171,-497,-175,1,100,3,510
1777157280088
3
0,-176,-497,-175,1,100,3,30
0,-178,-497,-174,-17,100,3,9
0,-260,-505,-174,-18,99,3,471
1777157280592
4
0,-301,-509,-174,-17,99,3,240
0,-304,-510,-173,23,99,3,12
0,-334,-506,-177,6,98,3,170
0,-350,-505,-175,6,97,3,88
1777157281114
2
0,-423,-502,-175,6,97,3,420
0,-433,-502,-31,1,97,5,90
1777157281629
1
0,-433,-502,0,0,97,5,510
1777157282132
2
0,-433,-502,0,0,97,5,30
0,-352,-505,175,-6,97,2,480
1777157282645
4
0,-334,-506,173,-23,97,2,102
0,-304,-509,173,-23,98,2,168
0,-304,-510,174,17,98,2,4
0,-263,-506,176,18,99,2,236
1777157283143
3
0,-178,-497,175,18,99,2,480
0,-178,-497,176,-1,99,2,3
0,-173,-497,177,-1,100,2,27
1777157283668
1
0,-84,-498,175,-1,100,2,510
1777157284177
3
0,-47,-498,170,-40,100,2,211
0,3,-510,174,-7,101,2,293
0,4,-510,175,-7,102,2,6
1777157284686
1
0,93,-514,175,-7,102,2,510
1777157285195
4
0,99,-514,171,-35,102,2,34
0,139,-524,171,-35,103,2,236
0,180,-626,168,-186,0,6,240
1777157285709
2
0,195,-634,168,-6,0,6,90
0,266,-468,168,670,0,6,420
1777157286209
4
0,286,-387,168,670,0,6,120
0,289,-375,24,-4,0,6,18
0,329,-382,172,-32,38,2,255
0,349,-386,172,-32,39,2,117
1777157286714
4
0,359,-387,172,-32,39,2,60
0,361,-388,172,28,39,2,9
0,398,-382,175,37,40,2,209
0,439,-373,179,39,41,2,232
1777157287236
5
0,444,-371,178,38,41,2,30
0,449,-371,182,0,41,2,25
0,492,-371,175,0,42,2,245
0,495,-371,174,7,42,2,16
0,529,-370,175,7,43,2,194
1777157287750
3
0,539,-369,175,7,43,2,60
0,548,-368,31,1,43,4,90
0,549,-369,0,0,43,4,360
1777157288255
4
0,549,-368,0,0,43,4,30
0,499,-370,-174,-7,43,3,300
0,495,-371,-175,0,43,3,23
0,468,-371,-175,0,42,3,157
1777157288765
4
0,452,-371,-175,0,42,3,90
0,449,-371,-171,-36,42,3,18
0,398,-382,-172,-28,41,3,298
0,380,-385,-173,-28,40,3,104
1777157289262
4
0,364,-387,-172,-28,40,3,90
0,361,-388,-172,32,40,3,19
0,329,-382,-178,31,39,3,180
0,290,-375,-177,31,38,3,221
1777157289776
3
0,279,-373,-177,30,38,3,60
0,269,-371,-35,6,38,5,90
0,269,-372,0,0,38,5,360
