1777162400016
2
0,700,-531,0,0,132,5,360
0,723,-536,172,-34,132,2,150
1777162400518
3
0,753,-541,171,-34,132,2,180
0,754,-542,172,26,132,2,0
0,812,-533,177,28,133,2,330
1777162401041
3
0,827,-530,177,27,133,2,90
0,831,-530,178,-17,133,2,17
0,901,-537,174,-17,134,2,403
1777162401549
4
0,906,-539,174,-16,134,2,30
0,963,-649,173,-6,0,6,330
0,989,-628,173,294,0,6,150
1777162402057
4
0,994,-618,173,354,0,6,30
0,994,-617,79,-2,0,6,2
0,1044,-619,173,-23,125,2,309
0,1073,-623,173,-23,126,2,169
1777162402561
2
0,1074,-623,173,17,126,2,5
0,1163,-614,176,18,127,2,505
1777162403069
3
0,1199,-610,175,18,127,2,210
0,1200,-610,176,-1,127,2,0
0,1253,-610,175,-1,128,2,300
1777162403589
2
0,1331,-611,170,-40,128,2,445
0,1342,-614,170,-41,129,2,65
1777162404088
2
0,1381,-623,174,-7,129,2,229
0,1430,-625,175,-7,130,2,281
1777162404598
4
0,1477,-627,171,-35,130,2,268
0,1497,-631,171,-35,131,2,122
0,1506,-633,30,-6,131,4,90
0,1507,-633,0,0,131,4,30
1777162405109
3
0,1507,-633,0,0,131,4,300
0,1477,-627,-182,7,131,3,183
0,1472,-627,-182,8,130,3,27
1777162405623
1
0,1383,-623,-175,7,130,3,510
1777162406103
3
0,1381,-623,-170,40,130,3,11
0,1331,-611,-184,1,129,3,280
0,1292,-611,-175,1,128,3,219
1777162406635
1
0,1203,-610,-175,1,128,3,510
1777162407150
2
0,1200,-610,-174,-17,128,3,17
0,1114,-619,-174,-18,127,3,493
1777162407663
4
0,1077,-622,-174,-17,127,3,210
0,1074,-623,-173,23,127,3,19
0,1044,-619,-177,6,126,3,170
0,1024,-618,-175,6,125,3,111
1777162408164
1
0,935,-615,-175,6,125,3,510
1777162408690
3
0,934,-615,-175,6,125,3,5
0,880,-534,-113,11,0,7,304
0,847,-532,-176,17,134,3,201
1777162409191
3
0,831,-530,-175,17,134,3,90
0,831,-530,-174,-27,134,3,0
0,758,-541,-173,-27,133,3,420
1777162409702
4
0,754,-542,-171,34,133,3,23
0,715,-534,-178,35,132,3,217
0,705,-532,-36,7,132,5,90
0,705,-532,0,0,132,5,180
