1777163236049
2
0,-58,-1262,0,0,47,5,270
0,-19,-1270,172,-34,47,2,240
1777163236561
3
0,-8,-1272,171,-34,47,2,60
0,-5,-1273,172,26,47,2,21
0,71,-1261,177,28,48,2,429
1777163237065
2
0,72,-1261,178,-17,48,2,5
0,160,-1270,174,-17,49,2,505
1777163237557
4
0,165,-1270,174,9,49,2,28
0,233,-1266,175,9,50,2,392
0,236,-1266,168,-48,50,2,13
0,249,-1270,168,-49,51,2,77
1777163238085
4
0,298,-1284,174,-11,51,2,291
0,328,-1286,171,-34,52,2,171
0,333,-1287,173,-23,53,2,29
0,336,-1287,173,-23,54,2,19
1777163238580
3
0,362,-1290,173,-23,54,2,150
0,363,-1291,174,17,54,2,5
0,425,-1285,176,18,55,2,355
1777163239110
3
0,488,-1278,175,18,55,2,360
0,489,-1278,176,-1,55,2,3
0,515,-1278,175,-1,56,2,147
1777163239602
1
0,604,-1279,175,-1,56,2,510
1777163240127
3
0,620,-1279,170,-40,56,2,91
0,670,-1291,174,-7,57,2,293
0,692,-1292,175,-7,58,2,126
1777163240639
2
0,766,-1295,171,-35,58,2,423
0,781,-1298,171,-36,59,2,87
1777163241141
2
0,790,-1300,30,-6,59,4,90
0,791,-1300,0,0,59,4,420
1777163241657
2
0,766,-1295,-182,7,59,3,155
0,704,-1292,-175,7,58,3,355
1777163242163
3
0,670,-1291,-170,40,58,3,194
0,620,-1279,-184,1,57,3,280
0,613,-1279,-175,1,56,3,36
1777163242669
1
0,524,-1278,-175,1,56,3,510
1777163243191
3
0,492,-1278,-175,1,56,3,180
0,489,-1278,-174,-17,56,3,19
0,435,-1284,-174,-18,55,3,311
1777163243680
3
0,367,-1290,-174,-17,55,3,390
0,363,-1291,-173,23,55,3,23
0,346,-1289,-176,24,54,3,97
1777163244210
4
0,333,-1287,-174,34,54,3,73
0,328,-1286,-179,11,53,3,28
0,298,-1284,-168,49,52,3,170
0,255,-1272,-181,53,51,3,239
1777163244715
5
0,238,-1266,-181,52,51,3,90
0,236,-1266,-188,-10,51,3,14
0,169,-1269,-174,-9,50,3,376
0,165,-1270,-174,16,50,3,27
0,164,-1270,-174,17,49,3,3
1777163245229
1
0,74,-1261,-176,17,49,3,510
1777163245739
4
0,72,-1261,-174,-27,49,3,11
0,-3,-1272,-172,-26,48,3,439
0,-5,-1273,-171,34,48,3,5
0,-15,-1271,-178,36,47,3,55
1777163246236
3
0,-47,-1264,-178,35,47,3,180
0,-56,-1262,-36,7,47,5,90
0,-57,-1263,0,0,47,5,240
