1740258957484
2
0,-769,82,0,0,71,5,360
0,-769,67,0,0,-3,15,150
1740258957997
1
0,-769,16,0,0,-3,15,510
1740258958509
1
0,-769,-35,0,0,-3,15,510
1740258959018
1
0,-769,-86,0,0,-3,15,510
1740258959530
5
0,-769,-111,0,0,-3,15,180
0,-769,-111,0,0,0,7,30
0,-769,-110,0,60,0,7,30
0,-769,-108,0,0,0,7,20
0,-769,-108,0,0,43,5,250
