1740259108960
3
0,-1559,-108,0,0,49,5,240
0,-1559,-106,0,0,49,11,30
0,-1559,-82,0,0,-4,15,240
1740259109466
1
0,-1559,-31,0,0,-4,15,510
1740259109983
1
0,-1559,20,0,0,-4,15,510
1740259110490
1
0,-1559,71,0,0,-4,15,510
1740259110986
5
0,-1559,83,0,0,-4,15,90
0,-1559,83,0,0,0,7,30
0,-1559,97,0,240,0,7,120
0,-1559,102,0,0,0,7,16
0,-1559,102,0,0,87,5,254
