1740259007469
4
0,-902,-108,0,0,42,5,480
0,-902,-108,-42,0,42,3,30
0,-913,-128,0,0,42,3,0
0,-913,-128,0,0,-2,15,0
1740259007976
1
0,-913,-179,0,0,-2,15,510
1740259008490
1
0,-913,-230,0,0,-2,15,510
1740259008997
1
0,-913,-281,0,0,-2,15,510
1740259009504
5
0,-913,-321,0,0,-2,15,330
0,-913,-321,0,0,0,7,30
0,-913,-320,0,60,0,7,30
0,-913,-318,0,0,0,7,20
0,-913,-318,0,0,11,5,100
