1740259057451
3
0,-1453,-318,0,0,28,5,210
0,-1453,-316,0,0,28,11,30
0,-1453,-289,0,0,-1,15,270
1740259057955
1
0,-1453,-238,0,0,-1,15,510
1740259058470
1
0,-1453,-187,0,0,-1,15,510
1740259058980
1
0,-1453,-136,0,0,-1,15,510
1740259059487
5
0,-1453,-127,0,0,-1,15,60
0,-1453,-127,0,0,0,7,30
0,-1453,-112,0,240,0,7,120
0,-1453,-108,0,0,0,7,16
0,-1453,-108,0,0,51,5,284
