1738532831150
3
0,673,4,0,0,57,5,210
0,675,4,72,0,57,2,51
0,715,4,184,0,59,2,249
1738532831660
4
0,748,4,183,0,59,2,180
0,765,4,81,0,59,4,128
0,770,4,9,0,60,4,112
0,771,4,0,0,60,4,90
