1738537542349
3
0,1056,-266,0,0,47,4,450
0,1056,-266,0,0,47,4,60
1738537543361
3
0,1056,-266,0,0,47,4,270
0,1034,-266,-133,0,47,3,210
0,1031,-266,-110,0,47,5,30
1738537543885
2
0,1023,-266,-14,0,47,5,120
0,1023,-266,0,0,47,5,390
