1775420425992
4
0,1757,214,0,0,139,4,240
0,1763,214,148,0,139,2,60
0,1770,214,4,0,139,4,90
0,1771,214,0,0,139,4,120
1775420426504
2
0,1770,212,0,0,139,4,60
0,1770,167,0,0,-4,14,450
1775420427013
1
0,1770,116,0,0,-4,14,510
1775420427522
1
0,1770,65,0,0,-4,14,510
1775420428032
1
0,1770,14,0,0,-4,14,510
1775420428544
1
0,1770,-37,0,0,-4,14,510
1775420429054
5
0,1770,-59,0,0,-4,14,150
0,1770,-59,0,0,0,6,30
0,1770,-58,0,60,0,6,30
0,1770,-56,0,0,0,6,20
0,1770,-56,0,0,11,4,280
