1775420508613
4
0,4063,94,0,0,171,4,330
0,4060,94,-175,0,171,3,30
0,4051,94,-31,0,171,5,90
0,4051,94,0,0,171,5,60
1775420509633
3
0,4058,94,175,0,171,2,60
0,4068,92,0,0,171,2,0
0,4068,47,0,0,-2,14,450
1775420510129
1
0,4068,-4,0,0,-2,14,510
1775420510651
1
0,4068,-55,0,0,-2,14,510
1775420511156
1
0,4068,-106,0,0,-2,14,510
1775420511669
1
0,4068,-157,0,0,-2,14,510
1775420512182
5
0,4068,-179,0,0,-2,14,150
0,4068,-179,0,0,0,6,30
0,4068,-178,0,60,0,6,30
0,4068,-176,0,0,0,6,20
0,4068,-176,0,0,75,4,280
