1775420476485
4
0,3263,94,0,0,157,4,60
0,3276,94,175,0,157,2,90
0,3285,94,31,0,157,4,90
0,3286,94,0,0,157,4,270
1775420476991
4
0,3286,94,0,0,157,4,30
0,3283,94,-175,0,157,3,30
0,3273,92,0,0,157,3,0
0,3273,47,0,0,-1,15,450
1775420477493
1
0,3273,-4,0,0,-1,15,510
1775420478012
1
0,3273,-55,0,0,-1,15,510
1775420478523
1
0,3273,-106,0,0,-1,15,510
1775420479034
5
0,3273,-119,0,0,-1,15,60
0,3273,-119,0,0,0,7,30
0,3273,-118,0,60,0,7,30
0,3273,-116,0,0,0,7,20
0,3273,-116,0,0,62,5,370
