1775420405593
5
0,1770,-56,0,0,11,4,60
0,1763,-56,-148,0,11,3,60
0,1756,-56,-4,0,11,5,90
0,1756,-56,0,0,11,5,90
0,1756,-56,0,0,11,11,210
1775420406096
4
0,1756,-56,0,0,11,11,180
0,1762,-56,148,0,11,2,60
0,1770,-54,0,0,11,2,0
0,1770,-27,0,0,-4,14,270
1775420406613
1
0,1770,24,0,0,-4,14,510
1775420407121
1
0,1770,75,0,0,-4,14,510
1775420407629
1
0,1770,126,0,0,-4,14,510
1775420408127
1
0,1770,177,0,0,-4,14,510
1775420408647
3
0,1770,213,0,0,-4,14,330
0,1770,214,0,0,0,6,60
0,1770,214,0,0,139,10,120
1775420409153
1
0,1770,214,0,0,139,4,510
