1775420457606
3
0,2524,-56,0,0,48,4,420
0,2531,-56,175,0,48,2,60
0,2536,-56,127,0,48,4,30
1775420458121
6
0,2540,-56,31,0,48,4,60
0,2541,-56,0,0,48,4,120
0,2541,-56,0,0,48,10,120
0,2533,-56,-175,0,48,3,60
0,2524,-54,0,0,48,3,0
0,2524,-39,0,0,-3,15,150
1775420458631
1
0,2524,12,0,0,-3,15,510
1775420459144
1
0,2524,63,0,0,-3,15,510
1775420459653
1
0,2524,114,0,0,-3,15,510
1775420460163
3
0,2524,153,0,0,-3,15,360
0,2524,154,0,0,0,7,60
0,2524,154,0,0,132,11,90
1775420460667
2
0,2524,154,0,0,132,11,30
0,2524,154,0,0,132,5,480
