1775420517776
7
0,4060,-176,-175,0,75,3,60
0,4050,-176,-31,0,75,5,90
0,4058,-176,175,0,75,2,60
0,4067,-176,31,0,75,4,90
0,4068,-176,0,0,75,4,30
0,4068,-174,0,0,75,10,30
0,4068,-159,0,0,-2,14,150
1775420518301
1
0,4068,-108,0,0,-2,14,510
1775420518809
1
0,4068,-57,0,0,-2,14,510
1775420519321
1
0,4068,-6,0,0,-2,14,510
1775420519833
1
0,4068,45,0,0,-2,14,510
1775420520342
3
0,4068,93,0,0,-2,14,450
0,4068,94,0,0,0,6,60
0,4068,94,0,0,171,4,0
