1775420492291
3
0,3273,-116,0,0,62,5,300
0,3273,-114,0,0,62,11,30
0,3273,-96,0,0,-1,15,180
1775420492801
1
0,3273,-45,0,0,-1,15,510
1775420493311
1
0,3273,6,0,0,-1,15,510
1775420493807
1
0,3273,57,0,0,-1,15,510
1775420494330
4
0,3273,93,0,0,-1,15,330
0,3273,94,0,0,0,7,60
0,3273,94,0,0,157,11,30
0,3273,94,0,0,157,5,90
