1775420540226
3
0,4404,-176,0,0,79,4,270
0,4417,-176,175,0,79,2,89
0,4443,-176,175,0,83,2,151
1775420540740
4
0,4455,-176,175,0,83,2,68
0,4493,-176,175,0,84,2,217
0,4495,-176,175,0,0,6,15
0,4532,-132,175,420,0,6,210
1775420541241
4
0,4592,93,150,670,0,6,360
0,4592,94,75,0,0,6,1
0,4595,94,27,0,177,4,59
0,4609,94,175,0,177,2,90
1775420541761
3
0,4630,94,175,0,177,2,120
0,4639,94,31,0,177,4,90
0,4640,94,0,0,177,4,300
