1775420199546
3
0,1308,-56,0,0,2,5,150
0,1343,-56,148,0,2,2,250
0,1359,-56,149,0,9,2,110
1775420200063
2
0,1395,-56,148,0,9,2,241
0,1435,-56,149,0,4,2,269
1775420200574
2
0,1485,-56,148,0,4,2,336
0,1511,-56,149,0,3,2,174
1775420201083
2
0,1575,-56,148,0,3,2,430
0,1587,-56,149,0,1,2,80
1775420201584
1
0,1663,-56,149,0,1,2,510
1775420202097
2
0,1665,-56,148,0,1,2,13
0,1739,-56,149,0,10,2,497
1775420202614
2
0,1755,-56,148,0,10,2,107
0,1815,-56,149,0,11,2,403
1775420203124
2
0,1845,-56,148,0,11,2,201
0,1891,-56,149,0,12,2,309
1775420203634
2
0,1935,-56,148,0,12,2,295
0,1967,-56,149,0,13,2,215
1775420204145
2
0,2025,-56,148,0,13,2,389
0,2043,-56,149,0,16,2,121
1775420204653
2
0,2115,-56,148,0,16,2,484
0,2119,-56,149,0,17,2,26
1775420205163
2
0,2167,-56,148,0,17,2,322
0,2195,-56,149,0,14,2,188
1775420205669
2
0,2243,-56,148,0,14,2,322
0,2271,-56,149,0,91,2,188
1775420206183
3
0,2280,-56,148,0,91,2,60
0,2323,-56,148,0,92,2,289
0,2347,-56,149,0,89,2,161
1775420206693
2
0,2347,-56,149,0,89,2,0
0,2423,-56,149,0,55,2,510
1775420207201
3
0,2423,-56,149,0,55,2,0
0,2475,-56,148,0,57,2,349
0,2499,-56,149,0,48,2,161
1775420207714
2
0,2565,-56,148,0,48,2,443
0,2575,-56,149,0,70,2,67
1775420208206
4
0,2588,-57,148,0,70,2,90
0,2628,-136,148,-26,0,6,270
0,2651,-118,149,274,0,6,150
1775420208733
4
0,2651,-116,74,0,0,6,6
0,2655,-116,123,0,68,2,43
0,2693,-116,148,0,47,2,259
0,2723,-116,149,0,69,2,202
1775420209246
2
0,2745,-116,148,0,69,2,147
0,2799,-116,149,0,66,2,363
1775420209752
2
0,2835,-116,148,0,66,2,241
0,2875,-116,149,0,43,2,269
1775420210263
2
0,2925,-116,148,0,43,2,336
0,2951,-116,149,0,61,2,174
1775420210759
2
0,3015,-116,148,0,61,2,430
0,3027,-116,149,0,44,2,80
1775420211265
1
0,3103,-116,149,0,44,2,510
1775420211793
2
0,3105,-116,148,0,44,2,13
0,3179,-116,149,0,60,2,497
1775420212302
2
0,3195,-116,148,0,60,2,107
0,3255,-116,149,0,62,2,403
1775420212813
2
0,3285,-116,148,0,62,2,201
0,3331,-116,149,0,63,2,309
1775420213323
2
0,3375,-116,148,0,63,2,295
0,3407,-116,149,0,65,2,215
1775420213833
2
0,3465,-116,148,0,65,2,389
0,3483,-116,149,0,64,2,121
1775420214339
2
0,3555,-116,148,0,64,2,484
0,3559,-116,149,0,72,2,26
1775420214850
1
0,3635,-116,149,0,72,2,510
1775420215366
2
0,3645,-116,148,0,72,2,67
0,3711,-116,149,0,74,2,443
1775420215874
3
0,3733,-116,148,0,74,2,150
0,3735,-116,123,-82,74,2,11
0,3778,-145,124,-83,73,2,349
1775420216385
3
0,3822,-174,123,-82,73,2,360
0,3825,-176,148,0,73,2,19
0,3844,-176,149,0,77,2,131
1775420216880
2
0,3915,-176,148,0,77,2,477
0,3920,-176,149,0,76,2,33
1775420217400
1
0,3996,-176,149,0,76,2,510
1775420217912
2
0,4005,-176,148,0,76,2,60
0,4072,-176,149,0,75,2,450
1775420218419
2
0,4095,-176,148,0,75,2,154
0,4148,-176,149,0,82,2,356
1775420218927
2
0,4185,-176,148,0,82,2,248
0,4224,-176,149,0,81,2,262
1775420219441
2
0,4275,-176,148,0,81,2,342
0,4300,-176,149,0,80,2,168
1775420219951
2
0,4365,-176,148,0,80,2,436
0,4376,-176,149,0,79,2,74
1775420220464
2
0,4417,-176,148,0,79,2,275
0,4452,-176,149,0,83,2,235
1775420220970
4
0,4455,-176,148,0,83,2,20
0,4456,-176,148,0,84,2,10
0,4463,-176,4,0,84,4,90
0,4463,-176,0,0,84,4,390
1775420221481
3
0,4463,-176,0,0,84,4,210
0,4455,-176,-148,0,84,3,68
0,4420,-176,-149,0,83,3,232
1775420221977
3
0,4417,-176,-148,0,83,3,20
0,4365,-176,-148,0,79,3,349
0,4344,-176,-149,0,80,3,141
1775420222499
2
0,4275,-176,-148,0,80,3,463
0,4268,-176,-149,0,81,3,47
1775420223013
1
0,4192,-176,-149,0,81,3,510
1775420223522
2
0,4185,-176,-148,0,81,3,47
0,4116,-176,-149,0,82,3,463
1775420224036
2
0,4095,-176,-148,0,82,3,141
0,4040,-176,-149,0,75,3,369
1775420224543
2
0,4005,-176,-148,0,75,3,235
0,3964,-176,-149,0,76,3,275
1775420225053
2
0,3915,-176,-148,0,76,3,329
0,3888,-176,-149,0,77,3,181
1775420225555
3
0,3825,-176,-148,0,77,3,420
0,3825,-176,-123,82,77,3,3
0,3813,-168,-162,108,73,3,87
1775420226054
3
0,3735,-116,-161,107,73,3,480
0,3735,-116,-194,0,73,3,1
0,3729,-116,-195,0,74,3,29
1775420226582
1
0,3652,-116,-149,0,74,3,510
1775420227083
2
0,3645,-116,-148,0,74,3,47
0,3576,-116,-149,0,72,3,463
1775420227603
2
0,3555,-116,-148,0,72,3,141
0,3500,-116,-149,0,64,3,369
1775420228101
2
0,3465,-116,-148,0,64,3,235
0,3424,-116,-149,0,65,3,275
1775420228624
2
0,3375,-116,-148,0,65,3,329
0,3348,-116,-149,0,63,3,181
1775420229132
2
0,3285,-116,-148,0,63,3,423
0,3272,-116,-149,0,62,3,87
1775420229642
1
0,3196,-116,-149,0,62,3,510
1775420230152
2
0,3195,-116,-148,0,62,3,6
0,3120,-116,-149,0,60,3,504
1775420230663
2
0,3105,-116,-148,0,60,3,100
0,3044,-116,-149,0,44,3,410
1775420231170
2
0,3015,-116,-148,0,44,3,194
0,2968,-116,-149,0,61,3,316
1775420231664
2
0,2925,-116,-148,0,61,3,289
0,2892,-116,-149,0,43,3,221
1775420232193
2
0,2835,-116,-148,0,43,3,383
0,2816,-116,-149,0,66,3,127
1775420232692
2
0,2745,-116,-148,0,66,3,477
0,2740,-116,-149,0,69,3,33
1775420233212
2
0,2693,-116,-148,0,69,3,315
0,2664,-116,-149,0,47,3,195
1775420233722
4
0,2655,-116,-148,0,47,3,60
0,2617,-116,-148,0,68,3,255
0,2614,-116,-148,0,0,7,15
0,2588,-84,-149,360,0,7,180
1775420234221
4
0,2579,-58,-149,480,0,7,60
0,2578,-56,-74,0,0,7,5
0,2565,-56,-148,0,70,3,107
0,2515,-56,-149,0,48,3,338
1775420234742
2
0,2475,-56,-148,0,48,3,268
0,2439,-56,-149,0,57,3,242
1775420235258
2
0,2423,-56,-148,0,57,3,107
0,2363,-56,-149,0,55,3,403
1775420235757
3
0,2347,-56,-148,0,55,3,107
0,2323,-56,-148,0,89,3,161
0,2287,-56,-149,0,92,3,242
1775420236272
3
0,2280,-56,-148,0,92,3,47
0,2243,-56,-148,0,91,3,248
0,2211,-56,-149,0,14,3,215
1775420236771
2
0,2167,-56,-148,0,14,3,295
0,2135,-56,-149,0,17,3,215
1775420237291
2
0,2115,-56,-148,0,17,3,134
0,2059,-56,-149,0,16,3,376
1775420237802
2
0,2025,-56,-148,0,16,3,228
0,1983,-56,-149,0,13,3,282
1775420238305
2
0,1935,-56,-148,0,13,3,322
0,1907,-56,-149,0,12,3,188
1775420238824
2
0,1845,-56,-148,0,12,3,416
0,1831,-56,-149,0,11,3,94
1775420239327
1
0,1755,-56,-149,0,11,3,510
1775420239845
2
0,1755,-56,-149,0,11,3,0
0,1679,-56,-149,0,10,3,510
1775420240353
2
0,1665,-56,-148,0,10,3,94
0,1603,-56,-149,0,1,3,416
1775420240880
2
0,1575,-56,-148,0,1,3,188
0,1527,-56,-149,0,3,3,322
1775420241366
2
0,1485,-56,-148,0,3,3,282
0,1451,-56,-149,0,4,3,228
1775420241871
2
0,1395,-56,-148,0,4,3,376
0,1375,-56,-149,0,9,3,134
1775420242385
4
0,1343,-56,-148,0,9,3,215
0,1308,-56,-148,0,2,3,235
0,1305,-56,-109,0,2,5,24
0,1302,-56,-62,0,8,5,36
1775420242901
2
0,1300,-56,-14,0,8,5,30
0,1301,-56,0,0,8,5,480
