1738538549744
4
0,615,-266,0,0,41,5,120
0,615,-266,0,0,41,5,390
1738538550259
2
0,615,-266,0,0,41,5,360
0,601,-266,-144,0,41,3,150
1738538550770
3
0,583,-266,-143,0,41,3,120
0,571,-266,-23,0,41,5,150
0,571,-266,0,0,41,5,240
