1738537563252
3
0,1023,-266,0,0,47,5,180
0,1023,-266,0,0,47,5,330
1738537564277
4
0,1023,-266,0,0,47,5,120
0,1044,-266,133,0,47,2,210
0,1055,-266,13,0,47,4,150
0,1056,-266,0,0,47,4,30
