1738530818149
2
0,894,4,0,0,62,5,270
0,868,4,-134,0,62,3,240
1738530818657
4
0,855,4,-133,0,62,3,97
0,839,4,-133,0,60,3,113
0,828,4,-13,0,60,5,150
0,829,4,0,0,60,5,150
