1738530852323
4
0,877,4,0,0,62,4,180
0,855,4,-133,0,62,3,212
0,843,4,-133,0,60,3,88
0,840,4,-110,0,60,5,30
1738530852826
2
0,832,4,-14,0,60,5,120
0,832,4,0,0,60,5,390
