1738537592827
3
0,976,-266,0,0,46,4,90
0,976,-266,0,0,46,4,420
1738537593339
4
0,976,-266,0,0,46,4,150
0,990,-266,133,0,46,2,153
0,997,-266,133,0,47,2,57
0,1009,-266,14,0,47,4,150
1738537593881
1
0,1009,-266,0,0,47,4,510
