1738533002419
2
0,820,4,0,0,60,4,300
0,842,4,134,0,60,2,210
1738533002919
2
0,855,4,133,0,60,2,97
0,910,4,134,0,62,2,413
1738533003444
3
0,922,4,133,0,62,2,90
0,933,4,13,0,62,4,150
0,933,4,0,0,62,4,270
