1776913028437
2
0,370,182,0,0,32,5,240
0,325,182,-175,0,32,3,270
1776913028946
1
0,236,182,-175,0,32,3,510
1776913029457
1
0,147,182,-175,0,32,3,510
1776913029963
1
0,58,182,-175,0,32,3,510
1776913030476
1
0,-31,182,-175,0,32,3,510
1776913030986
1
0,-120,182,-175,0,32,3,510
1776913031495
1
0,-209,182,-175,0,32,3,510
1776913032007
1
0,-298,182,-175,0,32,3,510
1776913032516
2
0,-366,182,-175,0,32,3,390
0,-370,182,0,0,32,3,120
1776913033022
2
0,-370,182,0,0,32,3,30
0,-370,182,0,0,32,5,480
1776913033530
2
0,-370,182,0,0,32,5,390
0,-352,182,175,0,32,2,120
1776913034045
1
0,-263,182,175,0,32,2,510
1776913034554
1
0,-174,182,175,0,32,2,510
1776913035067
1
0,-85,182,175,0,32,2,510
1776913035576
1
0,4,182,175,0,32,2,510
1776913036086
1
0,93,182,175,0,32,2,510
1776913036596
1
0,182,182,175,0,32,2,510
1776913037105
1
0,271,182,175,0,32,2,510
1776913037615
1
0,360,182,175,0,32,2,510
1776913038123
3
0,365,182,175,0,32,2,30
0,370,182,0,0,32,2,120
0,370,182,0,0,32,4,360
