1739835528274
2
0,414,34,0,0,62,4,240
0,444,34,139,0,62,2,270
1739835528778
5
0,450,34,138,0,62,2,43
0,469,33,138,0,58,2,137
0,506,-43,138,-15,0,6,270
0,515,-41,139,105,0,6,60
1739835529289
6
0,523,-31,139,225,0,6,60
0,526,-26,69,0,0,6,18
0,540,-26,138,0,37,2,120
0,554,-26,138,0,35,2,102
0,565,-26,18,0,35,4,150
0,566,-26,0,0,35,4,60
