1739835338037
7
0,-256,-206,0,0,17,4,60
0,-256,-206,0,0,17,4,30
0,-192,-421,0,180,0,6,90
0,-192,-416,0,0,0,6,30
0,-192,-416,0,0,9,4,300
