1739835027449
3
0,900,34,-130,0,53,3,100
0,862,34,-138,0,52,3,276
0,843,34,-139,0,48,3,134
1739835027966
2
0,810,34,-138,0,48,3,237
0,772,34,-139,0,49,3,273
1739835028469
2
0,720,34,-138,0,49,3,374
0,701,34,-139,0,51,3,136
1739835028977
1
0,630,34,-139,0,51,3,510
1739835029490
2
0,630,34,-139,0,51,3,0
0,559,34,-139,0,50,3,510
1739835029999
2
0,540,34,-138,0,50,3,136
0,488,34,-139,0,58,3,374
1739835030513
2
0,450,34,-138,0,58,3,273
0,417,34,-139,0,62,3,237
1739835031020
2
0,360,34,-138,0,62,3,410
0,346,34,-139,0,63,3,100
1739835031529
1
0,275,34,-139,0,63,3,510
1739835032054
2
0,270,34,-138,0,63,3,36
0,204,34,-139,0,64,3,474
1739835032549
2
0,180,34,-138,0,64,3,172
0,133,34,-139,0,59,3,338
1739835033060
2
0,90,34,-138,0,59,3,309
0,62,34,-139,0,61,3,201
1739835033569
2
0,0,34,-138,0,61,3,446
0,-9,34,-139,0,60,3,64
1739835034079
1
0,-80,34,-139,0,60,3,510
1739835034589
2
0,-90,34,-138,0,60,3,72
0,-151,34,-139,0,66,3,438
1739835035099
2
0,-180,34,-138,0,66,3,208
0,-222,34,-139,0,65,3,302
1739835035611
2
0,-270,34,-138,0,65,3,345
0,-293,34,-139,0,70,3,165
1739835036117
3
0,-322,34,-138,0,70,3,208
0,-360,34,-138,0,67,3,273
0,-364,34,-139,0,69,3,29
1739835036629
2
0,-367,34,-114,0,69,5,30
0,-368,34,0,0,69,5,480
1739835037142
4
0,-368,34,0,0,69,5,60
0,-360,34,133,0,69,2,107
0,-322,34,138,0,67,2,274
0,-312,34,139,0,70,2,69
1739835037649
2
0,-270,34,138,0,70,2,302
0,-241,34,139,0,65,2,208
1739835038159
2
0,-180,34,138,0,65,2,439
0,-170,34,139,0,66,2,71
1739835038685
1
0,-99,34,139,0,66,2,510
1739835039178
2
0,-90,34,138,0,66,2,64
0,-28,34,139,0,60,2,446
1739835039693
2
0,0,34,138,0,60,2,201
0,43,34,139,0,61,2,309
1739835040198
2
0,90,34,138,0,61,2,338
0,114,34,139,0,59,2,172
1739835040719
2
0,180,34,138,0,59,2,475
0,185,34,139,0,64,2,35
1739835041236
1
0,256,34,139,0,64,2,510
1739835041727
2
0,270,34,138,0,64,2,100
0,327,34,139,0,63,2,410
1739835042242
2
0,360,34,138,0,63,2,237
0,398,34,139,0,62,2,273
1739835042750
2
0,450,34,138,0,62,2,374
0,469,34,139,0,58,2,136
1739835043259
1
0,540,34,139,0,58,2,510
1739835043768
2
0,540,34,139,0,58,2,0
0,611,34,139,0,50,2,510
1739835044278
2
0,630,34,138,0,50,2,136
0,682,34,139,0,51,2,374
1739835044790
2
0,720,34,138,0,51,2,273
0,753,34,139,0,49,2,237
1739835045299
2
0,810,34,138,0,49,2,410
0,824,34,139,0,48,2,100
1739835045810
2
0,862,34,138,0,48,2,273
0,895,34,139,0,52,2,237
1739835046320
4
0,900,34,138,0,52,2,36
0,907,34,138,0,53,2,54
0,908,34,0,0,53,2,30
0,908,34,0,0,53,4,390
