1739835059581
2
0,477,-206,0,0,19,5,270
0,451,-206,-139,0,19,3,240
1739835060090
2
0,412,-206,-138,0,19,3,281
0,380,-206,-139,0,23,3,229
1739835060598
2
0,360,-206,-138,0,23,3,144
0,309,-206,-139,0,26,3,366
1739835061121
2
0,270,-206,-138,0,26,3,281
0,238,-206,-139,0,24,3,229
1739835061620
2
0,180,-206,-138,0,24,3,417
0,167,-206,-139,0,27,3,93
1739835062134
1
0,96,-206,-139,0,27,3,510
1739835062642
2
0,90,-206,-138,0,27,3,43
0,25,-206,-139,0,25,3,467
1739835063149
2
0,0,-206,-138,0,25,3,180
0,-46,-206,-139,0,21,3,330
1739835063664
2
0,-90,-206,-138,0,21,3,317
0,-117,-206,-139,0,18,3,193
1739835064170
2
0,-180,-206,-138,0,18,3,454
0,-188,-206,-139,0,22,3,56
1739835064681
2
0,-232,-206,-138,0,22,3,317
0,-259,-206,-139,0,17,3,193
1739835065192
3
0,-292,-206,-138,0,17,3,240
0,-304,-206,-18,0,17,5,150
0,-304,-206,0,0,17,5,120
1739835065698
2
0,-304,-206,0,0,17,5,270
0,-278,-206,139,0,17,2,240
1739835066212
2
0,-232,-206,138,0,17,2,331
0,-207,-206,139,0,22,2,179
1739835066719
2
0,-180,-206,138,0,22,2,194
0,-136,-206,139,0,18,2,316
1739835067228
2
0,-90,-206,138,0,18,2,331
0,-65,-206,139,0,21,2,179
1739835067739
2
0,0,-206,138,0,21,2,468
0,6,-206,139,0,25,2,42
1739835068250
1
0,77,-206,139,0,25,2,510
1739835068764
2
0,90,-206,138,0,25,2,93
0,148,-206,139,0,27,2,417
1739835069269
2
0,180,-206,138,0,27,2,230
0,219,-206,139,0,24,2,280
1739835069777
2
0,270,-206,138,0,24,2,367
0,290,-206,139,0,26,2,143
1739835070303
2
0,360,-206,138,0,26,2,504
0,361,-206,139,0,23,2,6
1739835070813
2
0,412,-206,138,0,23,2,367
0,432,-206,139,0,19,2,143
1739835071325
3
0,469,-206,138,0,19,2,270
0,481,-206,18,0,19,4,150
0,482,-206,0,0,19,4,90
