1768786183910
3
0,1147,275,0,0,315,4,330
0,1156,275,137,0,315,2,120
0,1163,275,90,0,315,10,60
1768786184421
8
0,1167,275,18,0,315,10,90
0,1168,334,0,0,127,4,59
1768786184928
4
0,1168,334,0,0,127,4,330
0,1170,334,72,0,127,2,51
0,1173,334,114,0,103,2,39
0,1181,334,42,0,103,4,90
1768786185432
2
0,1181,334,18,0,103,4,30
0,1182,334,0,0,103,4,480
