1768786255313
3
0,1116,154,0,0,167,4,180
0,1080,154,-137,0,167,3,311
0,1077,154,-137,0,178,3,19
1768786255828
3
0,1042,154,-137,0,178,3,254
0,1039,154,-137,0,0,7,16
0,1007,212,-137,480,0,7,240
1768786256341
6
0,986,303,-130,670,0,7,150
0,982,323,-124,670,0,6,30
0,980,334,0,0,0,6,15
0,980,334,0,0,117,2,15
0,990,334,137,0,117,2,122
0,1014,334,138,0,114,2,178
1768786256840
3
0,1026,334,137,0,114,2,90
0,1038,334,17,0,114,4,150
0,1038,334,0,0,114,4,270
