1768786227268
2
0,1134,154,0,0,168,4,330
0,1152,154,138,0,168,2,180
1768786227762
7
0,1163,154,17,0,168,10,150
0,1163,154,0,0,168,10,30
1768786228282
3
0,1164,220,0,0,316,4,465
