1739835209014
2
0,-242,34,0,0,65,5,390
0,-252,34,-139,0,65,3,120
1739835209522
8
0,-263,34,-18,0,65,5,150
0,-264,34,0,0,65,5,210
0,-264,34,0,0,65,5,30
0,-248,-210,0,180,0,7,90
0,-248,-206,0,0,0,7,25
0,-248,-206,0,0,17,5,5
