1739835606301
2
0,735,-148,0,0,32,5,330
0,735,-166,0,0,-2,15,180
1739835606814
1
0,735,-217,0,0,-2,15,510
1739835607320
1
0,735,-268,0,0,-2,15,510
1739835607828
1
0,735,-319,0,0,-2,15,510
1739835608339
1
0,735,-370,0,0,-2,15,510
1739835608851
5
0,735,-419,0,0,-2,15,420
0,735,-419,0,0,0,7,30
0,735,-418,0,60,0,7,30
0,735,-416,0,0,0,7,20
0,735,-416,0,0,12,5,10
