1778295759198
2
0,30,172,0,0,23,4,240
0,30,145,0,0,-2,16,270
1778295759702
1
0,30,94,0,0,-2,16,510
1778295760207
1
0,30,43,0,0,-2,16,510
1778295760732
1
0,30,-8,0,0,-2,16,510
1778295761233
6
0,30,-44,0,0,-2,16,300
0,30,-44,0,0,0,6,30
0,30,-43,0,60,0,6,30
0,30,-41,-8,1,0,6,12
0,29,-41,-8,1,12,4,18
0,30,-42,0,0,12,4,120
