1778295819358
3
0,-179,173,0,0,23,4,180
0,-179,62,0,-6,0,6,330
1778295819871
3
0,-179,62,0,54,0,6,30
0,-179,62,0,0,0,6,0
0,-179,15,0,0,-1,16,480
1778295820390
1
0,-179,-36,0,0,-1,16,510
1778295820900
1
0,-179,-87,0,0,-1,16,510
1778295821408
3
0,-179,-117,0,0,-1,16,360
0,-206,-143,-227,-93,0,7,150
1778295821912
5
0,-212,-144,-226,-33,0,7,30
0,-253,-118,-226,327,0,7,180
0,-254,-116,-89,-12,0,7,3
0,-258,-117,-41,-5,21,5,57
0,-259,-117,0,0,21,5,240
