1778295920323
3
0,-177,173,0,0,23,4,480
0,-177,154,0,-606,0,6,30
1778295920845
5
0,-177,77,0,-246,0,6,180
0,-177,62,-8,-6,0,7,120
0,-178,62,-8,54,0,7,30
0,-179,62,0,0,0,7,0
0,-179,45,0,0,-1,17,180
1778295921341
1
0,-179,-6,0,0,-1,17,510
1778295921849
1
0,-179,-57,0,0,-1,17,510
1778295922367
1
0,-179,-108,0,0,-1,17,510
1778295922874
1
0,-179,-159,0,0,-1,17,510
1778295923393
1
0,-179,-210,0,0,-1,17,510
1778295923902
1
0,-179,-261,0,0,-1,17,510
1778295924412
6
0,-179,-305,0,0,-1,17,390
0,-179,-305,0,0,0,7,30
0,-179,-304,0,60,0,7,30
0,-179,-302,1,0,0,7,10
0,-178,-302,1,0,6,5,20
0,-179,-303,0,0,6,5,30
