1778295770920
3
0,30,-41,0,0,12,4,240
0,30,-39,0,0,12,10,30
0,30,-15,0,0,-2,16,240
1778295771446
1
0,30,36,0,0,-2,16,510
1778295771949
1
0,30,87,0,0,-2,16,510
1778295772458
1
0,30,138,0,0,-2,16,510
1778295772970
3
0,30,173,0,0,-2,16,330
0,30,174,0,0,0,6,60
0,30,174,0,0,23,10,120
1778295773481
1
0,30,174,0,0,23,4,510
