1778295947346
3
0,140,-38,0,0,14,5,450
0,140,-74,0,-546,0,7,60
1778295947872
4
0,140,-148,0,-6,0,7,270
0,140,-147,0,54,0,7,30
0,134,-147,0,0,0,7,0
0,134,-169,0,0,-3,17,210
1778295948460
1
0,134,-220,0,0,-3,17,510
1778295948866
1
0,134,-271,0,0,-3,17,510
1778295949591
1
0,134,-322,0,0,-3,17,510
1778295949978
1
0,134,-352,0,0,-3,17,510
1778295950391
3
0,134,-352,0,0,-3,17,480
0,134,-352,-227,-333,0,7,30
1778295950914
4
0,99,-379,-226,-33,0,7,150
0,31,-299,-226,567,0,7,300
0,27,-287,-100,-4,0,7,19
0,24,-288,-53,-2,11,5,41
1778295951439
6
0,23,-287,-5,0,11,5,30
0,15,-287,-174,-7,11,3,60
0,12,-288,-175,0,11,3,18
0,4,-288,-175,0,10,3,42
0,-4,-288,-31,0,10,5,90
0,-5,-288,0,0,10,5,270
