1778295832105
3
0,-202,-110,0,0,22,4,120
0,-196,-110,175,10,22,2,49
0,-136,3,172,670,0,6,341
1778295832629
4
0,-96,163,160,670,0,6,240
0,-94,174,80,0,0,6,15
0,-67,174,175,0,23,2,165
0,-59,174,31,0,23,4,90
1778295833136
1
0,-59,174,0,0,23,4,510
