1778295985084
6
0,-230,-113,0,0,21,4,90
0,-212,-111,177,11,21,2,116
0,-196,-110,175,10,22,2,90
0,-184,-105,175,130,0,6,64
0,-179,-105,0,0,0,6,0
0,-179,-121,0,0,-1,16,150
1778295985599
1
0,-179,-172,0,0,-1,16,510
1778295986104
1
0,-179,-223,0,0,-1,16,510
1778295986614
1
0,-179,-274,0,0,-1,16,510
1778295987135
6
0,-179,-305,0,0,-1,16,240
0,-179,-305,0,0,0,6,30
0,-179,-304,0,60,0,6,30
0,-179,-302,1,0,0,6,10
0,-178,-302,1,0,6,4,20
0,-179,-303,0,0,6,4,180
