1778295933083
3
0,-179,-302,0,0,6,5,270
0,-179,-300,0,0,6,11,30
0,-179,-279,0,0,-1,17,210
1778295933597
1
0,-179,-234,0,0,-1,17,510
1778295934166
4
0,-179,-234,0,0,-1,17,0
0,-144,-261,227,-33,0,6,180
0,-81,-163,162,627,0,7,330
1778295934637
3
0,-26,157,66,670,0,7,480
0,-24,174,0,0,0,7,24
0,-24,174,0,0,23,3,6
1778295935107
3
0,-58,174,-175,0,23,3,210
0,-67,174,-31,0,23,5,90
0,-68,174,0,0,23,5,210
