1778295957545
4
0,-5,-288,0,0,10,5,300
0,8,-288,175,0,10,2,90
0,12,-288,174,7,10,2,22
0,29,-287,175,7,11,2,98
1778295958064
2
0,85,-285,175,7,11,2,319
0,118,-251,175,367,0,6,191
1778295958579
3
0,175,-52,175,670,0,6,330
0,179,-39,54,-5,0,6,19
0,204,-42,174,-17,14,2,161
1778295959086
4
0,230,-44,174,-16,14,2,150
0,231,-45,165,9,14,4,5
0,243,-44,21,1,15,4,115
0,244,-44,0,0,15,4,240
