1778295997839
10
0,-258,-312,0,0,3,5,120
0,-266,-312,-170,47,3,3,60
0,-271,-310,-170,47,2,3,30
0,-275,-309,-124,34,2,5,30
0,-280,-308,-31,8,2,11,60
0,-280,-307,0,0,2,11,120
1778295998354
4
0,-281,-115,-50,7,20,5,1
0,-282,-115,-3,1,20,5,30
1778295998859
6
0,-282,-115,0,0,20,5,30
0,-269,-117,172,-26,20,2,90
0,-264,-117,125,-19,20,4,30
0,-264,-118,116,15,20,4,5
0,-256,-117,21,2,21,4,85
0,-257,-117,0,0,21,4,270
