1778295108096
3
0,592,158,0,0,31,5,60
0,577,162,-182,7,31,3,99
0,515,165,-175,7,30,3,351
1778295108604
3
0,481,166,-170,40,30,3,194
0,431,178,-184,1,29,3,280
0,424,178,-175,1,28,3,36
1778295109123
1
0,335,179,-175,1,28,3,510
1778295109625
4
0,303,178,-175,1,28,3,180
0,300,179,-174,-17,28,3,19
0,251,174,-174,-18,27,3,281
0,246,173,-174,-18,26,3,30
1778295110136
3
0,178,166,-174,-18,26,3,390
0,174,166,-173,23,26,3,23
0,157,168,-176,24,25,3,97
1778295110646
2
0,144,170,-177,6,25,3,73
0,67,173,-175,6,24,3,437
1778295111155
3
0,35,173,-175,6,24,3,180
0,34,174,-175,0,24,3,8
0,-22,174,-175,0,23,3,322
1778295111676
1
0,-111,174,-175,0,23,3,510
1778295112169
1
0,-200,174,-175,0,23,3,510
1778295112688
1
0,-289,174,-175,0,23,3,510
1778295113196
2
0,-367,174,-175,0,23,3,450
0,-370,174,0,0,23,3,60
1778295113704
2
0,-370,174,0,0,23,3,150
0,-370,174,0,0,23,5,360
1778295114223
2
0,-370,174,0,0,23,5,330
0,-341,174,175,0,23,2,180
1778295114736
1
0,-252,174,175,0,23,2,510
1778295115237
1
0,-163,174,175,0,23,2,510
1778295115743
1
0,-74,174,175,0,23,2,510
1778295116257
1
0,15,174,175,0,23,2,510
1778295116772
3
0,30,174,175,0,23,2,90
0,34,174,174,-6,23,2,18
0,104,171,175,-6,24,2,402
1778295117274
4
0,144,170,173,-23,24,2,228
0,172,166,173,-23,25,2,162
0,174,166,174,18,25,2,10
0,193,168,176,18,26,2,110
1778295117792
2
0,251,174,175,17,26,2,329
0,283,177,176,18,27,2,181
1778295118295
3
0,298,178,175,17,27,2,90
0,300,179,176,-1,27,2,6
0,373,178,175,-1,28,2,414
1778295118802
2
0,431,178,170,-40,28,2,331
0,461,171,170,-41,29,2,179
1778295119315
2
0,481,166,174,-7,29,2,117
0,550,163,175,-7,30,2,393
1778295119822
4
0,577,162,171,-35,30,2,154
0,591,158,171,-35,31,2,86
0,595,158,0,0,31,2,120
0,595,158,0,0,31,4,150
