1768773684108
2
0,3398,332,0,0,157,5,420
0,3398,323,0,0,-2,15,90
1768773684620
1
0,3398,272,0,0,-2,15,510
1768773685130
1
0,3398,221,0,0,-2,15,510
1768773685629
1
0,3398,170,0,0,-2,15,510
1768773686152
5
0,3398,121,0,0,-2,15,420
0,3398,121,0,0,0,7,30
0,3398,121,0,60,0,7,30
0,3398,124,0,0,0,7,20
0,3398,124,0,0,36,5,10
