1768775812548
4
0,5370,453,0,0,202,5,120
0,5370,376,0,-15,0,7,270
0,5370,389,0,225,0,7,120
1768775813053
3
0,5370,396,0,285,0,7,30
0,5370,396,0,0,0,7,0
0,5370,349,0,0,-1,15,480
1768775813578
1
0,5370,298,0,0,-1,15,510
1768775814089
1
0,5370,247,0,0,-1,15,510
1768775814597
1
0,5370,196,0,0,-1,15,510
1768775815099
5
0,5370,151,0,0,-1,15,390
0,5370,151,0,0,0,7,30
0,5370,151,0,60,0,7,30
0,5370,154,0,0,0,7,20
0,5370,154,0,0,225,5,40
