1768894303477
2
0,1051,334,0,0,114,4,420
0,1057,334,126,0,114,2,90
1768894303987
2
0,1080,334,137,0,114,2,168
0,1127,334,138,0,127,2,342
1768894304487
2
0,1170,334,137,0,127,2,312
0,1197,334,138,0,103,2,198
1768894305004
4
0,1209,334,137,0,103,2,90
0,1221,334,17,0,103,4,150
0,1221,334,0,0,103,4,180
0,1216,334,-126,0,103,3,90
1768894305516
3
0,1170,334,-137,0,103,3,335
0,1158,334,-137,0,127,3,85
0,1149,334,-65,0,127,5,90
1768894306015
2
0,1146,334,-17,0,127,5,60
0,1146,334,0,0,127,5,450
