1768773756532
2
0,3398,126,0,0,36,10,30
0,3398,174,0,0,-2,14,480
1768773757042
1
0,3398,225,0,0,-2,14,510
1768773757548
1
0,3398,276,0,0,-2,14,510
1768773758061
1
0,3398,327,0,0,-2,14,510
1768773758569
4
0,3398,333,0,0,-2,14,30
0,3398,334,0,0,0,6,60
0,3398,334,0,0,157,10,210
0,3398,334,0,0,157,4,210
