1768774136482
3
0,6244,-176,0,0,86,4,120
0,6255,-176,137,0,86,2,130
0,6291,-176,138,0,87,2,260
1768774136987
4
0,6293,-176,137,0,87,2,14
0,6295,-176,137,0,0,6,16
0,6307,-167,137,180,0,6,90
0,6308,33,0,670,0,6,390
1768774137486
1
0,6308,375,0,670,0,6,510
1768774138010
5
0,6308,435,0,670,0,6,90
0,6308,454,0,0,0,6,28
0,6308,454,0,0,209,4,212
0,6300,454,-132,0,209,3,107
0,6290,454,-137,0,208,3,73
1768774138523
3
0,6277,454,-137,0,208,3,90
0,6266,454,-17,0,208,5,150
0,6266,454,0,0,208,5,270
