1768775880893
2
0,5584,94,0,0,279,4,360
0,5598,94,138,0,279,2,150
1768775881397
3
0,5618,94,137,0,279,2,145
0,5618,94,137,0,0,6,5
0,5668,223,134,670,0,6,360
1768775881920
4
0,5706,444,101,670,0,6,330
0,5708,454,49,0,0,6,15
0,5710,454,1,0,194,4,75
0,5710,454,0,0,194,4,90
1768775882414
4
0,5710,454,0,0,194,4,90
0,5715,454,126,0,194,2,90
0,5725,454,6,0,194,4,150
0,5726,454,0,0,194,4,180
