1768775862027
2
0,5129,94,0,0,237,5,360
0,5115,94,-137,0,237,3,150
1768775862522
3
0,5092,94,-137,0,237,3,167
0,5090,94,-137,0,0,7,13
0,5045,203,-137,660,0,7,330
1768775863048
4
0,5002,444,-101,670,0,7,360
0,5000,454,-49,0,0,7,15
0,4997,454,-1,0,187,5,75
0,4998,454,0,0,187,5,60
