1768775841628
3
0,5370,154,0,0,225,5,270
0,5370,156,0,0,225,11,30
0,5370,177,0,0,-1,15,210
1768775842124
1
0,5370,228,0,0,-1,15,510
1768775842648
1
0,5370,279,0,0,-1,15,510
1768775843159
1
0,5370,330,0,0,-1,15,510
1768775843652
1
0,5370,381,0,0,-1,15,510
1768775844177
1
0,5370,393,0,0,-1,15,510
1768775844689
5
0,5370,400,0,0,-1,15,60
0,5370,400,0,0,0,7,30
0,5370,444,0,420,0,7,210
0,5370,454,0,0,0,7,21
0,5370,454,0,0,202,5,189
