1768894322838
3
0,1274,334,0,0,128,5,120
0,1260,334,-137,0,128,3,151
0,1227,334,-137,0,103,3,239
1768894323366
2
0,1170,334,-137,0,103,3,414
0,1157,334,-137,0,127,3,96
1768894323862
3
0,1119,334,-137,0,127,3,270
0,1108,334,-17,0,127,5,150
0,1108,334,0,0,127,5,90
1768894324387
2
0,1108,334,0,0,127,5,180
0,1146,334,138,0,127,2,330
1768894324899
3
0,1170,334,137,0,127,2,174
0,1195,334,137,0,103,2,186
0,1207,334,18,0,103,4,150
1768894325388
1
0,1207,334,0,0,103,4,510
