1768786159949
5
0,1143,334,0,0,127,4,270
0,1148,334,126,0,127,2,90
0,1158,333,30,0,127,4,120
0,1159,317,30,-495,0,6,30
1768786160459
5
0,1166,255,29,-15,0,6,240
0,1169,268,29,225,0,6,120
0,1170,275,14,0,0,6,26
0,1170,275,14,0,315,4,4
0,1170,275,0,0,315,4,120
