1768786201749
5
0,1171,220,0,0,316,4,270
0,1168,219,-84,0,316,3,60
0,1156,177,-137,-375,0,7,90
0,1145,152,-119,-195,0,6,90
1768786202267
7
0,1135,142,-101,-15,0,6,90
0,1126,149,-83,165,0,6,90
0,1124,154,0,0,0,6,25
0,1124,154,0,0,179,2,5
0,1132,154,132,0,179,2,107
0,1150,154,137,0,168,2,133
0,1157,154,90,0,168,4,60
1768786202785
2
0,1161,154,18,0,168,4,90
0,1162,154,0,0,168,4,420
