1768773157944
2
0,3171,184,0,0,93,5,480
0,3172,184,42,0,93,2,30
1768773158451
2
0,3233,184,137,0,93,2,468
0,3239,184,138,0,94,2,42
1768773158964
2
0,3247,184,137,0,94,2,58
0,3309,184,138,0,90,2,452
1768773159475
7
0,3309,183,138,0,90,2,0
0,3346,106,137,-15,0,6,270
0,3362,118,137,225,0,6,120
0,3365,124,68,0,0,6,21
0,3375,124,137,0,39,2,90
0,3376,124,138,0,36,2,9
1768773159973
2
0,3413,124,137,0,36,2,269
0,3446,124,138,0,40,2,241
1768773160487
2
0,3465,124,137,0,40,2,138
0,3516,124,138,0,28,2,372
1768773160988
2
0,3555,124,137,0,28,2,283
0,3586,124,138,0,37,2,227
1768773161510
2
0,3645,124,137,0,37,2,429
0,3656,124,138,0,10,2,81
1768773162027
1
0,3726,124,138,0,10,2,510
1768773162520
2
0,3735,124,137,0,10,2,65
0,3796,124,138,0,32,2,445
1768773163047
2
0,3825,124,137,0,32,2,210
0,3866,124,138,0,31,2,300
1768773163554
2
0,3915,124,137,0,31,2,356
0,3936,124,138,0,33,2,154
1768773164067
2
0,4005,124,137,0,33,2,501
0,4006,124,138,0,34,2,9
1768773164573
1
0,4076,124,138,0,34,2,510
1768773165084
2
0,4095,124,137,0,34,2,138
0,4146,124,138,0,35,2,372
1768773165597
2
0,4185,124,137,0,35,2,283
0,4216,124,138,0,3,2,227
1768773166105
3
0,4237,124,137,0,3,2,152
0,4275,124,137,0,11,2,276
0,4286,124,138,0,12,2,82
1768773166608
6
0,4294,123,137,0,12,2,60
0,4331,46,137,-15,0,6,270
0,4347,58,137,225,0,6,120
0,4350,64,68,0,0,6,21
0,4353,64,111,0,57,2,39
1768773167126
4
0,4365,64,137,0,57,2,90
0,4403,64,137,0,49,2,276
0,4417,64,137,0,58,2,101
0,4423,64,138,0,52,2,43
1768773167628
6
0,4435,63,137,0,52,2,90
0,4472,-13,137,-15,0,6,270
0,4489,-1,137,225,0,6,120
0,4491,4,68,0,0,6,21
0,4492,4,69,0,65,2,9
1768773168147
5
0,4493,4,84,0,65,2,11
0,4507,4,137,0,81,2,117
0,4538,3,137,0,82,2,232
0,4560,-58,138,-255,0,6,150
1768773168656
5
0,4576,-74,138,-15,0,6,120
0,4593,-61,138,225,0,6,120
0,4596,-56,69,0,0,6,22
0,4597,-56,75,0,78,2,12
0,4626,-56,138,0,76,2,236
1768773169164
4
0,4654,-57,137,0,76,2,210
0,4692,-133,137,-15,0,6,270
0,4696,-133,138,45,0,6,30
1768773169669
4
0,4708,-120,138,225,0,6,90
0,4711,-116,69,0,0,6,18
0,4763,-116,137,0,45,2,397
0,4764,-116,138,0,47,2,5
1768773170186
2
0,4815,-116,137,0,47,2,370
0,4834,-116,138,0,48,2,140
1768773170716
1
0,4904,-116,138,0,48,2,510
1768773171206
2
0,4905,-116,137,0,48,2,7
0,4974,-116,138,0,50,2,503
1768773171715
2
0,4995,-116,137,0,50,2,152
0,5044,-116,138,0,68,2,358
1768773172224
2
0,5085,-116,137,0,68,2,298
0,5114,-116,138,0,59,2,212
1768773172738
2
0,5175,-116,137,0,59,2,443
0,5184,-116,138,0,62,2,67
1768773173244
1
0,5254,-116,138,0,62,2,510
1768773173755
2
0,5265,-116,137,0,62,2,79
0,5324,-116,138,0,55,2,431
1768773174268
2
0,5355,-116,137,0,55,2,225
0,5394,-116,138,0,64,2,285
1768773174777
3
0,5443,-116,137,0,64,2,360
0,5445,-116,114,-76,64,2,10
0,5461,-127,114,-76,63,2,140
1768773175285
1
0,5519,-166,114,-76,63,2,510
1768773175797
3
0,5532,-174,114,-76,63,2,120
0,5535,-176,137,0,63,2,19
0,5586,-176,138,0,60,2,371
1768773176305
2
0,5625,-176,137,0,60,2,283
0,5656,-176,138,0,61,2,227
1768773176817
2
0,5715,-176,137,0,61,2,429
0,5726,-176,138,0,73,2,81
1768773177324
1
0,5796,-176,138,0,73,2,510
1768773177834
2
0,5805,-176,137,0,73,2,65
0,5866,-176,138,0,72,2,445
1768773178345
2
0,5895,-176,137,0,72,2,210
0,5936,-176,138,0,69,2,300
1768773178853
2
0,5985,-176,137,0,69,2,356
0,6006,-176,138,0,70,2,154
1768773179361
2
0,6075,-176,137,0,70,2,501
0,6076,-176,138,0,71,2,9
1768773179876
1
0,6146,-176,138,0,71,2,510
1768773180386
2
0,6165,-176,137,0,71,2,138
0,6216,-176,138,0,67,2,372
1768773180878
5
0,6217,-176,137,0,67,2,7
0,6255,-176,137,0,86,2,276
0,6261,-176,137,0,87,2,47
0,6273,-176,17,0,87,4,150
0,6273,-176,0,0,87,4,30
1768773181914
3
0,6273,-176,0,0,87,4,210
0,6255,-176,-137,0,87,3,180
0,6239,-176,-137,0,86,3,120
1768773182426
2
0,6217,-176,-137,0,86,3,160
0,6169,-176,-137,0,67,3,350
1768773182936
2
0,6165,-176,-137,0,67,3,29
0,6099,-176,-137,0,71,3,481
1768773183445
2
0,6075,-176,-137,0,71,3,174
0,6029,-176,-137,0,70,3,336
1768773183954
2
0,5985,-176,-137,0,70,3,320
0,5959,-176,-137,0,69,3,190
1768773184453
2
0,5895,-176,-137,0,69,3,465
0,5889,-176,-137,0,72,3,45
1768773184975
1
0,5819,-176,-137,0,72,3,510
1768773185484
2
0,5805,-176,-137,0,72,3,101
0,5749,-176,-137,0,73,3,409
1768773185997
2
0,5715,-176,-137,0,73,3,247
0,5679,-176,-137,0,61,3,263
1768773186500
2
0,5625,-176,-137,0,61,3,392
0,5609,-176,-137,0,60,3,118
1768773187016
1
0,5539,-176,-137,0,60,3,510
1768773187526
2
0,5535,-176,-114,76,60,3,29
0,5464,-129,-150,100,63,3,481
1768773188034
3
0,5446,-116,-149,99,63,3,120
0,5445,-116,-179,0,63,3,6
0,5390,-116,-137,0,64,3,384
1768773188543
2
0,5355,-116,-137,0,64,3,254
0,5320,-116,-137,0,55,3,256
1768773189054
2
0,5265,-116,-137,0,55,3,400
0,5250,-116,-137,0,62,3,110
1768773189563
1
0,5180,-116,-137,0,62,3,510
1768773190075
2
0,5175,-116,-137,0,62,3,36
0,5110,-116,-137,0,59,3,474
1768773190587
2
0,5085,-116,-137,0,59,3,181
0,5040,-116,-137,0,68,3,329
1768773191094
2
0,4995,-116,-137,0,68,3,327
0,4970,-116,-137,0,50,3,183
1768773191608
2
0,4905,-116,-137,0,50,3,472
0,4900,-116,-137,0,48,3,38
1768773192116
1
0,4830,-116,-137,0,48,3,510
1768773192625
3
0,4815,-116,-137,0,48,3,109
0,4763,-116,-137,0,47,3,378
0,4760,-116,-137,0,45,3,23
1768773193135
1
0,4690,-116,-137,0,45,3,510
1768773193643
5
0,4687,-116,-137,0,45,3,21
0,4685,-116,-137,0,0,7,9
0,4652,-58,-137,480,0,7,240
0,4652,-56,-68,0,0,7,4
0,4623,-56,-137,0,76,3,236
1768773194156
3
0,4597,-56,-137,0,76,3,189
0,4583,-56,-137,0,78,3,101
0,4553,-56,-137,0,75,3,220
1768773194667
3
0,4507,-56,-137,0,75,3,334
0,4503,-56,-137,0,0,7,26
0,4483,-33,-137,300,0,7,150
1768773195176
5
0,4470,2,-137,480,0,7,90
0,4470,4,-68,0,0,7,4
0,4455,4,-137,0,65,3,135
0,4417,4,-137,0,80,3,276
0,4416,4,-137,0,0,7,5
1768773195668
4
0,4383,61,-137,480,0,7,240
0,4382,64,-68,0,0,7,4
0,4365,64,-137,0,49,3,150
0,4349,64,-137,0,57,3,116
1768773196196
5
0,4327,64,-137,0,57,3,160
0,4324,64,-137,0,0,7,20
0,4291,121,-137,480,0,7,240
0,4290,124,-68,0,0,7,4
0,4282,124,-137,0,12,3,86
1768773196700
3
0,4275,124,-137,0,12,3,50
0,4237,124,-137,0,11,3,276
0,4212,124,-137,0,3,3,184
1768773197213
2
0,4185,124,-137,0,3,3,196
0,4142,124,-137,0,35,3,314
1768773197723
2
0,4095,124,-137,0,35,3,341
0,4072,124,-137,0,34,3,169
1768773198228
2
0,4005,124,-137,0,34,3,487
0,4002,124,-137,0,33,3,23
1768773198746
1
0,3932,124,-137,0,33,3,510
1768773199239
2
0,3915,124,-137,0,33,3,123
0,3862,124,-137,0,31,3,387
1768773199755
2
0,3825,124,-137,0,31,3,269
0,3792,124,-137,0,32,3,241
1768773200248
2
0,3735,124,-137,0,32,3,414
0,3722,124,-137,0,10,3,96
1768773200782
1
0,3652,124,-137,0,10,3,510
1768773201294
2
0,3645,124,-137,0,10,3,50
0,3582,124,-137,0,37,3,460
1768773201805
2
0,3555,124,-137,0,37,3,196
0,3512,124,-137,0,28,3,314
1768773202314
2
0,3465,124,-137,0,28,3,341
0,3442,124,-137,0,40,3,169
1768773202825
3
0,3413,124,-137,0,40,3,210
0,3375,124,-137,0,36,3,276
0,3372,124,-137,0,39,3,24
1768773203334
3
0,3337,124,-137,0,39,3,254
0,3334,124,-137,0,0,7,16
0,3302,182,-137,480,0,7,240
1768773203847
3
0,3301,184,-68,0,0,7,4
0,3247,184,-137,0,90,3,419
0,3235,184,-137,0,94,3,87
1768773204354
3
0,3233,184,-137,0,94,3,14
0,3185,184,-137,0,93,3,346
0,3174,184,-17,0,93,5,150
1768773204864
1
0,3174,184,0,0,93,5,510
