1768785415351
3
0,837,274,0,0,125,4,30
0,862,274,137,0,125,2,231
0,896,274,138,0,129,2,249
1768785415858
4
0,900,274,137,0,129,2,29
0,938,274,137,0,130,2,276
0,941,274,137,0,0,6,25
0,966,306,138,360,0,6,180
1768785416353
4
0,974,331,138,480,0,6,60
0,974,334,69,0,0,6,5
0,990,334,137,0,117,2,142
0,1032,334,138,0,114,2,303
1768785416880
2
0,1080,334,137,0,114,2,349
0,1102,334,138,0,127,2,161
1768785417388
2
0,1170,334,137,0,127,2,494
0,1172,334,138,0,103,2,16
1768785417892
1
0,1242,334,138,0,103,2,510
1768785418408
2
0,1260,334,137,0,103,2,130
0,1312,334,138,0,128,2,380
1768785418909
2
0,1350,334,137,0,128,2,276
0,1382,334,138,0,104,2,234
1768785419428
3
0,1394,334,137,0,104,2,90
0,1406,334,17,0,104,4,150
0,1406,334,0,0,104,4,270
1768785419941
2
0,1406,334,0,0,104,4,150
0,1363,334,-137,0,104,3,360
1768785420433
2
0,1350,334,-137,0,104,3,94
0,1293,334,-137,0,128,3,416
1768785420959
2
0,1260,334,-137,0,128,3,240
0,1223,334,-137,0,103,3,270
1768785421452
2
0,1170,334,-137,0,103,3,385
0,1153,334,-137,0,127,3,125
1768785421972
1
0,1083,334,-137,0,127,3,510
1768785422487
2
0,1080,334,-137,0,127,3,21
0,1013,334,-137,0,114,3,489
1768785422983
4
0,990,334,-137,0,114,3,167
0,963,333,-137,0,117,3,193
0,943,272,-137,-255,0,7,150
1768785423507
5
0,926,255,-137,-15,0,7,120
0,910,268,-137,225,0,7,120
0,907,274,-68,0,0,7,22
0,900,274,-137,0,130,3,68
0,875,274,-137,0,129,3,180
1768785424004
4
0,862,274,-137,0,129,3,94
0,858,274,-137,0,125,3,26
0,846,274,-17,0,125,5,150
0,847,274,0,0,125,5,240
