1768786013578
2
0,1265,275,0,0,315,4,210
0,1231,275,-137,0,315,3,300
1768786014076
1
0,1161,275,-137,0,315,3,510
1768786014598
2
0,1099,275,-137,0,315,3,450
0,1092,275,-89,0,315,5,60
1768786015109
5
0,1087,275,-17,0,315,5,90
0,1086,275,0,0,315,5,360
0,1086,274,0,0,315,2,0
0,1094,244,110,-435,0,6,60
1768786015602
4
0,1117,196,110,-15,0,6,210
0,1133,217,110,285,0,6,150
0,1135,220,55,0,0,6,10
0,1150,220,138,0,316,2,140
1768786016127
2
0,1211,220,137,0,316,2,450
0,1219,220,90,0,316,4,60
1768786016637
8
0,1222,220,42,0,316,4,60
0,1223,220,18,0,316,10,30
0,1224,220,0,0,316,10,90
1768786017134
5
0,1224,275,0,0,315,4,126
0,1241,275,137,0,315,2,180
0,1253,275,17,0,315,4,150
0,1254,275,0,0,315,4,30
1768786018163
4
0,1254,275,0,0,315,4,210
0,1244,275,-137,0,315,3,120
0,1232,275,-17,0,315,5,150
0,1232,275,0,0,315,5,30
1768786018680
5
0,1232,274,0,0,315,5,90
0,1232,206,0,-195,0,7,180
0,1231,197,-8,-15,0,7,90
0,1230,217,-9,285,0,7,150
1768786019174
2
0,1230,220,-4,0,0,7,10
0,1170,220,-137,0,316,3,500
1768786019683
3
0,1129,220,-137,0,316,3,298
0,1128,220,-137,0,0,7,2
0,1100,264,-137,420,0,7,210
1768786020211
3
0,1096,275,-68,0,0,7,23
0,1092,275,-20,0,315,5,67
0,1093,275,0,0,315,5,420
1768786020721
2
0,1093,275,0,0,315,5,90
0,1144,275,138,0,315,2,420
1768786021222
1
0,1214,275,138,0,315,2,510
1768786021738
3
0,1247,275,137,0,315,2,240
0,1258,275,17,0,315,4,150
0,1259,275,0,0,315,4,120
