1739835270208
5
0,-172,-206,0,0,18,5,90
0,-180,-206,-133,0,18,3,107
0,-185,-206,-138,0,22,3,43
0,-192,-204,0,0,22,3,0
0,-192,-177,0,0,-4,15,270
1739835270720
1
0,-192,-126,0,0,-4,15,510
1739835271242
1
0,-192,-75,0,0,-4,15,510
1739835271738
1
0,-192,-24,0,0,-4,15,510
1739835272255
1
0,-192,27,0,0,-4,15,510
1739835272757
4
0,-192,33,0,0,-4,15,30
0,-192,34,0,0,0,7,60
0,-192,34,0,0,65,11,210
0,-192,34,0,0,65,5,210
