1779575851969
2
0,1615,574,0,0,97,5,420
0,1609,574,-126,0,97,3,90
1779575852461
9
0,1602,574,-78,0,97,5,60
0,1601,574,-36,0,97,2,30
0,1603,574,90,0,97,2,90
0,1608,574,18,0,97,4,90
0,1608,574,0,0,97,4,180
0,1608,574,0,0,97,4,30
0,1728,293,0,60,0,6,30
1779575852985
3
0,1728,300,0,180,0,6,60
0,1728,304,0,0,0,6,17
0,1728,304,0,0,75,4,433
