1779575817801
5
0,556,454,0,0,105,4,90
0,578,454,175,0,105,2,188
0,581,453,175,0,148,2,22
0,619,357,175,-246,0,6,210
1779575818298
4
0,640,341,175,-6,0,6,120
0,687,413,175,534,0,6,270
0,690,424,87,0,0,6,19
0,704,424,175,0,29,2,101
1779575818809
4
0,709,424,175,0,29,2,30
0,713,424,156,0,29,4,23
0,729,424,12,0,41,4,187
0,730,424,0,0,41,4,270
