1779575880521
3
0,1685,304,0,0,77,5,150
0,1717,304,137,0,77,2,282
0,1728,304,138,0,75,2,78
1779575881030
3
0,1793,304,137,0,75,2,472
0,1794,304,137,0,0,6,8
0,1798,305,138,60,0,6,30
1779575881540
2
0,1843,432,135,670,0,6,330
0,1865,554,99,670,0,7,180
1779575882056
2
0,1868,574,0,0,0,7,30
0,1809,574,-137,0,95,3,480
1779575882560
3
0,1800,574,-137,0,95,3,65
0,1747,574,-137,0,104,3,385
0,1740,574,-89,0,104,5,60
1779575883074
2
0,1735,574,-17,0,104,5,90
0,1735,574,0,0,104,5,420
