1779575758115
4
0,667,424,0,0,40,5,60
0,675,424,132,0,40,2,107
0,713,424,137,0,29,2,277
0,722,424,138,0,41,2,66
1779575758628
2
0,765,424,137,0,41,2,312
0,792,424,138,0,31,2,198
1779575759152
2
0,855,424,137,0,31,2,458
0,862,424,138,0,30,2,52
1779575759650
1
0,932,424,138,0,30,2,510
1779575760168
2
0,945,424,137,0,30,2,94
0,1002,424,138,0,32,2,416
1779575760673
2
0,1035,424,137,0,32,2,239
0,1072,424,138,0,33,2,271
1779575761189
2
0,1125,424,137,0,33,2,385
0,1142,424,138,0,35,2,125
1779575761701
1
0,1212,424,138,0,35,2,510
1779575762210
3
0,1215,424,137,0,35,2,21
0,1267,424,137,0,37,2,378
0,1282,424,138,0,42,2,111
1779575762721
4
0,1305,424,137,0,42,2,167
0,1323,423,137,0,43,2,133
0,1352,351,138,-135,0,6,210
1779575763213
4
0,1360,346,138,-15,0,6,60
0,1376,359,138,225,0,6,120
0,1379,364,69,0,0,6,18
0,1419,364,138,0,82,2,312
1779575763725
3
0,1433,364,137,0,82,2,101
0,1447,364,137,0,85,2,101
0,1489,364,138,0,83,2,308
1779575764249
6
0,1493,363,137,0,83,2,30
0,1530,286,137,-15,0,6,270
0,1546,298,137,225,0,6,120
0,1549,304,68,0,0,6,21
0,1556,304,138,0,79,2,69
1779575764748
3
0,1575,304,137,0,79,2,138
0,1613,304,137,0,74,2,276
0,1626,304,138,0,80,2,96
1779575765267
2
0,1665,304,137,0,80,2,283
0,1696,304,138,0,77,2,227
1779575765761
3
0,1717,304,137,0,77,2,152
0,1757,304,137,0,75,2,298
0,1765,304,90,0,75,4,60
1779575766276
2
0,1769,304,18,0,75,4,90
0,1770,304,0,0,75,4,420
1779575766866
2
0,1770,304,0,0,75,4,210
0,1736,304,-137,0,75,3,300
1779575767296
2
0,1717,304,-137,0,75,3,138
0,1666,304,-137,0,77,3,372
1779575767815
3
0,1665,304,-137,0,77,3,7
0,1613,304,-137,0,80,3,378
0,1596,304,-137,0,74,3,125
1779575768317
4
0,1575,304,-137,0,74,3,152
0,1537,304,-137,0,79,3,276
0,1533,304,-137,0,0,7,22
0,1526,308,-137,120,0,7,60
1779575768823
3
0,1501,362,-137,480,0,7,180
0,1500,364,-68,0,0,7,4
0,1459,364,-137,0,83,3,326
1779575769331
3
0,1447,364,-137,0,83,3,87
0,1433,364,-137,0,85,3,101
0,1389,364,-137,0,82,3,322
1779575769841
5
0,1357,364,-137,0,82,3,232
0,1355,364,-137,0,0,7,8
0,1322,421,-137,480,0,7,240
0,1322,424,-68,0,0,7,4
0,1320,424,-69,0,43,3,26
1779575770355
3
0,1305,424,-137,0,43,3,122
0,1267,424,-137,0,42,3,276
0,1252,424,-137,0,37,3,112
1779575770867
2
0,1215,424,-137,0,37,3,269
0,1182,424,-137,0,35,3,241
1779575771385
2
0,1125,424,-137,0,35,3,414
0,1112,424,-137,0,33,3,96
1779575771881
1
0,1042,424,-137,0,33,3,510
1779575772403
2
0,1035,424,-137,0,33,3,50
0,972,424,-137,0,32,3,460
1779575772914
2
0,945,424,-137,0,32,3,196
0,902,424,-137,0,30,3,314
1779575773421
2
0,855,424,-137,0,30,3,341
0,832,424,-137,0,31,3,169
1779575773921
2
0,765,424,-137,0,31,3,487
0,762,424,-137,0,41,3,23
1779575774452
2
0,713,424,-137,0,41,3,356
0,692,424,-137,0,29,3,154
1779575774950
4
0,675,424,-137,0,29,3,123
0,671,424,-137,0,40,3,27
0,659,424,-17,0,40,5,150
0,659,424,0,0,40,5,210
