1740258941160
2
0,-1559,82,0,0,87,5,390
0,-1559,70,0,0,-4,15,120
1740258941680
1
0,-1559,19,0,0,-4,15,510
1740258942187
1
0,-1559,-32,0,0,-4,15,510
1740258942697
1
0,-1559,-83,0,0,-4,15,510
1740258943206
5
0,-1559,-111,0,0,-4,15,210
0,-1559,-111,0,0,0,7,30
0,-1559,-110,0,60,0,7,30
0,-1559,-108,0,0,0,7,20
0,-1559,-108,0,0,49,5,220
