1740258979417
7
0,-1752,-108,0,0,64,5,90
0,-1752,-108,0,0,64,5,30
0,-1798,-320,0,180,0,7,90
0,-1798,-318,0,0,0,7,15
0,-1798,-318,0,0,40,5,285
