1740259040107
3
0,-913,-318,0,0,11,5,270
0,-913,-316,0,0,11,11,30
0,-913,-295,0,0,-2,15,210
1740259040619
1
0,-913,-244,0,0,-2,15,510
1740259041124
1
0,-913,-193,0,0,-2,15,510
1740259041639
1
0,-913,-142,0,0,-2,15,510
1740259042144
1
0,-913,-136,0,0,-2,15,510
1740259042659
1
0,-913,-130,0,0,-2,15,510
1740259043169
5
0,-913,-127,0,0,-2,15,60
0,-913,-127,0,0,0,7,30
0,-913,-112,0,240,0,7,120
0,-913,-108,0,0,0,7,16
0,-913,-108,0,0,42,5,284
